# AmpliSeq_Version=4.47
# Genome=hg19
# Workflow=DNA
# Total_Amplicons=2158
# Num_Pools=2
# Pool1=1084_amplicons
# Pool2=1074_amplicons
# FowrdPrim  ReversePrim InsertLength    AuxInfo(optional)
GTTATGATTTTGCAGAAAACAGATCTGT	AACAGTAGACACAAAACAGGCTCA	78	KRAS
TTTTTCAGTGGAGGTTAACATTCATCAAG	GTCCAGTCTTTGTGGCTAAAATGTTT	81	ATM
TTCCTTCTTCAATTTTTGTTGTTTCCATGT	GCAATTTACCTAGTAATGGGTTGTAACATC	73	ATM
GGGAGATTTATAAGATGACAACAGATCCA	CAGAACTGTTTTAGATATGCTGGGTATTCA	65	ATM
TTTGTGGTTTACTTTAAGATTACAAATTCAGAA	TCTGACTTATATGCTTCCTCTTCAGCTATTA	60	ATM
ATAATTTTGTGGGAGCTAGCAGTGT	ATCTCATTCACTAGCAGATCATATAAGTTGT	83	ATM
CTCCAGGCAGAAAAAGATGCAGGAA	AACTCACGCGACAGTAATCTGTTAA	74	ATM
TGCCGTCAAAGAAAATTTGATTGAATTGA	TTTAAAAGCCCAAAATGCCCAGTTTAA	70	ATM
CGCAAGATGGGATTATGGTGAAAC	CCGCAGTTGACTGAAATGTCAC	87	ATM
TCCTCCCACAGGATCTGCTTTA	CAAAGGAGTCCTCTCTGAGGACT	91	MPL
TTTTTACAGACAGTGATGTGTGTTCT	AAGTAATTTACTACCTTTCGTTCTGTAGCTC	67	ATM
CTACCGAAGATTGCAGCCTTCT	CTGCTGCCAATAGCTTAGTGGT	88	MPL
CTGTTCCTTAGATGTCTCCTTGCT	GGCATACAGCAGCTGGTATGTC	89	MPL
GCTGAGCCATAGACTGTGGTACT	CTCCCAGCTGATCTGAAGTTCC	83	MPL
GCCCTGATGGGACTTACTTCTT	GGTAGAAGAAGCCTTGGGAGCTA	81	MPL
CAGTGATTTCCTGAGGTACGAACT	GTCCAGAGCAGAGGCTGAGT	94	MPL
TGGCCGAGGTCTCGATGTA	CTCGGATGACGTGCCCAT	87	HRAS
CAGACGCTGGGCTATCGA	CGCGCAGCTGTAAACGGTA	97	MPL
CCCTATCCTGGCTGTGTCCT	GACCATCCAGCTGATCCAGAAC	82	HRAS
GCAGGCCTGATTCAATGACTCT	GCTGTCATTTCGTGACTTGAAGTG	92	MPL
CTACTGTTCTAGAAGGCAAATCACATTTATTTC	TGAAAGATATTTGTGTTACTAATGACTGTGCT	74	KRAS
ACAGCATTATTCACATCCTTGTGGA	AACTATGTGGGAAGAATGAGGAAGAAAG	71	MPL
AGACATCTGCTTTCTGCCAAAATTAATG	GGGAGATCCGACAATACAGATTGAAAAA	82	KRAS
CCCTGCTGACATCCCTGTAGT	GTATCGGAGTTGATAACAGGTCTCTTG	87	MPL
GCCTCTGGACCGGCTCATA	GATTACCGACTGCTCCTCTCAC	89	JAK3
TGTTGGTGAGGAAGGTGAAGC	GTGCTCCAGGACCCGAGAA	93	APC
GGTGAGCAGTGAAGGCATGAG	CCCTCAGGTTCACGAGCTC	99	JAK3
GGTGGGTATGGACACGTTCATC	CTCCTTCACCTTGCCGTAAGAG	94	STK11
GACACCACGATACTTGACAATGAAATC	CGCTAGGCGACAATACAGGT	92	JAK3
GCCGTCAAGATCCTCAAGAAGAAG	CAGAACCATCAGCACCGTGA	80	STK11
ACCTCCTTGCAGAAGAAGTGC	GGGTTTCACTGGGCTCTGAC	97	JAK3
TTGGAGAAGGGAAGTCGGAACA	ATCAGCTCGCCCTCCGTGA	98	STK11
TCTTACACCCAGTGGAGAAGCT	CCAGGGACCTTACCTTATACACC	79	EGFR
TGGGTCGGAAAACTGGACC	ACCGGTCCTTGGTGTCTGG	101	STK11
ACAACACACAGTTGGAGGACTT	CCCATCACACACCATAACTCC	84	ERBB2
GACTTCTGTGACTTCCCAGCT	AATCAGCTGACAGAAGTACCTGC	94	STK11
TGGAGCCGCTGACACCTAG	CCCTGACCTTGTAGACTGTGC	85	ERBB2
CTGATTGACGGCCTGGAGT	CCTAGCACGTGCCTACCT	98	STK11
CAGCCCTCTGACGTCCATC	CCGTTTCCTGCAGCAGTCT	101	ERBB2
TAAGCCATGTGGCTCATGTTACTATTAC	GGATTACTCTGAGACCTAGGCAAAAA	80	MLH1
CAAGATTCCGGGAGTTGGTGT	CTGCAGGAGGGTGCTCTTAG	83	ERBB2
TTTTTAATACAGACTTTGCTACCAGGAC	GAACCATCTGGTGGGCATAGAC	76	MLH1
GCTAGACTCCTGAGCAGAACCT	GGGATCCCATCGTAAGGTTTGG	93	ERBB2
CAGAAGCTTGATGCATTTCTGCA	GGCTGGGAGTTCAAGCATCTC	93	MLH1
TCTGCACCATTGATGTCTACATGATC	CCTGGGTCTACATACATCCTGGT	90	ERBB2
GGTATTGAATTTCTTTGGACCAGGTGAA	GAGGGTCGACTCCTCAGATATGTA	72	MLH1
AGAAAAACAAAATCTGCCTTTTTAACTGGT	GTTTTCAGAATATCCAGTTCCTGTGGAT	68	EGFR
GCGCCAAAATGTCGTTCGT	CCAGTTCTCAATCATCTCTTTGATAGCATT	75	MLH1
CCCACCTATAATGGTGAATATCTTCAAATGATT	GATATTCTCGACACAGCAGGTCAA	78	KRAS
ACCTAGATTGTGAAGCTGGGATTTTC	CGAGGGAGATCCCATCAGGTT	92	MPL
ACAAAAATTACCACTTGTACTAGTATGCCT	GAGAAATTCGAAAACATAAAGAAAAGATGAGC	76	KRAS
CGCTCTGCATCTAGTGCTGG	TTCGGCTCCACCTGGTCCA	88	MPL
TACCTCTATTGTTGGATCATATTCGTCCA	AAGGCCTGCTGAAAATGACTGAATATA	71	KRAS
ATGGGCTAAGGCAGGCACA	TGATCTCCACCCTCTGTGCA	98	MPL
CCTATGGCTTTCCAACCTAGGAAG	CGAGAGCTGAATGAGGCCTT	95	TP53
TCACTGACAGAGAGCAAGTTTTCTG	AAAAACTGAAAGTAAATAAAAAGCACACTGA	80	JAK2
GCCACTGACAACCACCCTTAAC	CGTGTGGAGTATTTGGATGACAGAAA	76	TP53
GGAGTTGACTTTCTAAAAGGTGCTATTTC	GGTAATGATGTGCATCTGCAGTTAATCTAT	80	JAK2
CGGCATTTTGAGTGTTAGACTGGA	CTAGCACTGCCCAACAACACCA	92	TP53
CCTCCAGCCGTGCTTGAA	CATACATGTATCACTCTGTTAAATCTTCTTTGT	83	JAK2
GCTAGGCTAAGCTATGATGTTCCTTAGA	GCCTGATACAGATGCTACTTGACTTA	74	TP53
GACCCTCTACAGGACAACACTG	CCCTTGTACTTTACAATGTTGTCATGC	90	JAK2
CTAAGAGCAATCAGTGAGGAATCAGA	GCACATGACGGAGGTTGTGA	93	TP53
AAAAATGAGAATGAAGAGTACAACCTCA	GGGACAGCATTTAGTAAACTGGAAAATTA	77	JAK2
ATGTGCTGTGACTGCTTGTAGAT	CCTGCCCTCAACAAGATGTTTTG	78	TP53
TTGTGAATTATTTAACCCTACTCTGTTCGT	ACTCCATTTGTCTGTTGCCAAATTTAAAT	65	JAK2
CGTAGCTGCCCTGGTAGGT	GAAGCTCCCAGAATGCCAGA	99	TP53
GAGATAAACCTCTAAGTGCTCTGGATT	CCAACCTTCTTTTTAAAATTAGATGGGCTAAAA	79	JAK2
AAGGTGATAAAAGTGAATCTGAGGCAT	GGAAGAGAATCTCCGCAAGAAAGG	87	TP53
GATTTTGCCATTAGTAAACTGAAGAAAGCA	GTGTTACCACTAATAAGTGTGACATACTAACC	76	JAK2
AGAGGTGGATGGGTAGTAGTATGG	CATCATCACACTGGAAGACTCCA	92	TP53
AAAACTAGCTGAAAGAAAAATGTTTTATCCA	AAAATCTCCAATTTTAACTCTGTTCTCGTTC	70	JAK2
CCGGTCAGAAAACCAAAATTATAAGCA	ATTTAAATGGGAATAGCCCTTCAATATTCT	82	EGFR
GGACACCAGTGTATGTTGGGAT	TGTGAGCGCAAGGCTTTATAGA	93	MLH1
CCCTTTAAACAATTAAGATCTCTCAGGAT	CTCACACAAACTAATTCTAGGTCAACAAAA	72	SMAD4
TACACCATATGTGGGCTTTTTCTCC	TGCAGGAAGTGAACTTCATGCTT	91	MLH1
GAATGTACCATGTTAATGTCTTCTTGTTCC	GCTGACCAGTAAATCCATTCTGCT	82	SMAD4
CCTTTGTTTAGATTACTCAACTCCACTAATTT	AACTAATGCCTGCATTGTGTACTGA	82	MLH1
CATCGTTGTCCACTGAAGGACAT	AGTGCTGGTAGCATTAGACTCAGAT	76	SMAD4
GGCTTCATTTGGATGCTCCGTTA	TCTTTGGGACCATCTTCCTCTGT	93	MLH1
TGATGTCTTCCAAATCTTTTCTGTTAGGT	TTGATGCTCTGTCTTGGGTAATCC	82	SMAD4
GACTTGCTGAATACATTGTTGAGTTTCT	CGGCTGGAAATTTTATTTGAAGAATACAAC	76	MLH1
CTTGCTGGATTGAAATTCACTTACACC	GTCCACCATCCTGATAAGGTTAAGG	86	SMAD4
GAAAGAGACATCGGGAAGATTCTGA	CTGCTCATTAATTTCTTCCTGGAGACT	87	MLH1
AAAAAGTAGGCAGCCTTTATAAAAGCA	CGTTTTGGTGGTGAGGCAAATT	75	SMAD4
TCCCATTTTGTCCCAACTGGTT	CCTGAGAACACCAAAATTGGCAAA	88	MLH1
CTGAGTTGGTAGGATTGTGAGGATTAAA	CAGAGACGGGCATAGATCACAT	88	SMAD4
CTGGATATTGTATGTGAAAGGTTCACTACT	AATGTCATCACAGGAGGATATTTTACACAT	79	MLH1
GCCTGATCTTCACAAAAATGAACTAAAACA	TTACCAATTCCAGGTGATACAACTCG	69	SMAD4
GGAGATGTTTGGCTTCAAAGAAGAA	TCACAGAGGATTTCTGAAAACATCTCAG	86	SMARCB1
GTTCTTTCCCATTTATTTCCTATAGCTCCT	TCCACGTATCCATCAACAGTAACAATAG	75	SMAD4
GAACCCGCTGACGTTTGTG	AGTGCTGGGTGAGAAGTCAC	96	SMARCB1
GCTTTTGTTTGGGTCAACTCTCCA	GGGAAAACATAACCTTGAATAAAAGACAATGTA	79	SMAD4
TCTGTTACAGATCACGGATACACGA	GGCTCTGTGCTGATGGACAC	79	SMARCB1
GGGTCAGGTGCCTTAGTGAC	AATTGTAACTAACCTTTATATATGCACTTGGGT	75	SMAD4
AGAAGTTTGCCCTGAAGCTGT	GGAGAGACTCATGCATGATCCT	95	SMARCB1
GCCTGCCCTTCCAATGGATC	CTCTTGCAGCAGCCAGACT	98	TP53
TGTACCTTTAATAATTCCTTTCTCTGCTTCTT	GCCTGGTTGACTCATCTATATGGAAG	81	JAK2
CTATTGCAAGCAAGGGTTCAAAGA	AAAAACTCATGTTCAAGACAGAAGGG	89	TP53
TTCCACCAATTAAAAGATGGCCCTTA	TCGAAGAGCTAGATCCCTAAAGGAG	86	JAK2
GATGGGTGAAAAGAGCAGTCAGA	CTCTTGTCTTTCAGACTTCCTGAAAAC	89	TP53
CGTTTGTATTTGAACTATTTGGAAGCTGA	TTCAGCACCTCGAGATATTCCATG	72	JAK2
TCCTTTAGCTGAAGAATATCTGTCAAAGC	CTCCGAATATCAGCTGCCCTAA	74	ATM
GTGCTGAAGCTCCTCTTCTTGA	CCTGATTAAGTGACTTATTAAACAGCAAGA	75	JAK2
TGATTCTAGCACGCTAGAACCTAC	CCATGTGATTCTTACATGTCAACTCATTAC	77	ATM
ATTGTTTTCTCTTACAGGCAAATGTTCTG	GGCATTTCCAGAAATATCACCATTCTGATA	69	JAK2
ATGTGGTTTCTTGCCTTTGTAAAGTTC	CTGTCTCAGGAGTAGGAAGGATTTTG	86	ATM
TGCCAATTCTATGAAGCAAATAGATCCA	CAATACAGATTTCTTCTGCAACATACTCC	67	JAK2
GTTCCTTTTAGACTCACCAGAGATATTGTG	CCAGCCCATGTAATTTTGACATCAAAAATT	69	ATM
AGAAGCTACAATTTTATGAAGATAGGCATCA	CGTATGATGGCTCTGAAAGAAGGC	71	JAK2
TGTTCCTCAGTTTGTCACTAAAATCTCTT	AATTGCAAATTACCTTAATTTCCATAGTAGGG	78	ATM
ATTGCGATTTTCCTAATATTATTGATGTCAGT	CCATTATTCAATCATAAAGCAAACTTACCAGAT	69	JAK2
ATTTCCTTTTAGTTTGTTAATGTGATGGAATAG	CATCAGTAATGGAGACAGCTCACA	82	ATM
ACTCATGAAACACAGGAAGAATGTCTT	CACACTTATGTGTAAGGATTTGCAAAAGAA	82	JAK2
TGTTACGATGCCTTACGGAAGTTG	AACTTATACCACGAAAGGTAATACACCAAA	71	ATM
ACATTTCATTTTACTCCTCTTTGGAGCA	TGGTGAGGTTGGTACATCAGAAAC	87	JAK2
GGCTTACTTGGAGCCATAATTCAGG	TTTATCTGTAAGTCAGACATAATGCATGCT	74	ATM
CTCACCAACATTACAGAGGCCTA	CAAGAAAACAGATGTTGTTTTAAAAGGACAAAA	81	JAK2
AGAAAGAGATGGAATCAGTGATTTCAGAT	ACCTAGATCTATATGTACAAGTTCTGCTGA	80	ATM
TATGGACAACAGTCAAACAACAATTCTTTG	GTCTCCACAGACACATACTCCATAATTTAA	72	JAK2
TTCATGTGAGAGGTATAATGAAACTGAGTTTT	CTGTCGATGACACTGACGCA	87	SMAD4
CCTTCCGGCTTCGGTTTC	TGCCCGAAGGTCTTGCTC	99	SMARCB1
CGTGGCAGGAAACATCCCT	GCTCAAAGAAACTAATCAACTGAGTAAATCAAG	87	SMAD4
CCTGTAGAGCCTTGGGAAGG	TGTGCTGATGGGCTGGTTAC	92	SMARCB1
GATCAAAATTGCTTCAGAAATTGGAGACA	TCTATGGCACATCAAACTATGCACA	85	SMAD4
GCATAGAATGAGATGTTGTCTTGGATGA	GATGTGAGAGATTATAATGAGTTGTCCACT	69	FLT3
TAGACAAGGTGGAGAGAGTGAAACA	GATGAGCTCCATTTGTAGTTATAGCTGTTA	69	SMAD4
TCTTTGTCATCAAGCTACAGTCTTTTTGA	ACTCATGTCAGAACTCAAGATGATGAC	83	FLT3
CAAGAGGGTGGTTCCCAGAATT	GAGTGAAGGGCAATGAAGGGTA	93	ERBB2
CACATTCCACACTACAGCGACTA	GAAACGACACCGGATACTACACTT	85	FLT3
GGCAGTGTGTATGCAGGCAT	GGGAGATCTTGTGCACGGT	99	FGFR3
GATACAAAAGCAAACAGAATCCGTATCAT	GCAGGAACAATTAACTAATAGTCTGGATTGAAA	76	FLT3
CTTTGGAGGGACTGCCTATCTT	CAGATCAAAGGGTGGTCATTTGC	80	MLH1
TACGCAGTTACTGTTAGTCCCTGAT	CATAAGGTGCTGTGCCAGAAATG	88	FLT3
GACTTTCTAGTAACTCAGCAGCATCT	GCTACAGTGAAATCTCGATGGAGT	89	BRAF
CCAATGGAAAAGAAATGCTGCAGA	TCCTCAGATAATGAGTACTTCTACGTTGAT	82	FLT3
GCATACTTCCATCTAATACAAATATGTTCCC	ACAGACCTCCTCCTGGCGAC	83	CDKN2A
CTGTACCATCTGTAGCTGGCTT	CACAAGTACAAAAAGGTAAAAGCAAAGGTA	84	FLT3
AGAATCGAAGCGCTACCTGATTC	CTGCCCAACGCACCGAATA	94	CDKN2A
GCATTCATTTCCATTTTAAAGTGCTACTACT	TTTTTAATAGCATGCCTGGTTCAAGA	82	FLT3
TACTTACCATGCCACTTTCCCTTG	CTGTTTTTATCAAGAAAACACTTGGTAGACG	83	BRAF
AGGAAGACAGCAACAAGTGTTTTAATTTAC	AAACGGCCATCCTTCCCTAATT	87	FLT3
TTAAGGAACACTGTCCATTGGCAT	AGTAACACCAATAGGGTTCAGCAAAT	89	PIK3CA
ACTTGAAACAAAATTCCAAATGAACCACA	GAACATTTCCTGTCTCTGGGTCTT	78	FLT3
ATTCTGTTTATGAAGGAGTTATGTGTGTGT	GCTGTTTCGAGGTCATATGTTACTAGG	74	ATM
GCCAATTTAATTTCTTTACCTATAATGGTCAC	TACAAACTCCTGAACCAGAATATCTGC	78	JAK2
TTGTCCTTTGGTGAAGCTATTTATACATGT	AGAGCATTGTACAATGATTCATGGTAACT	71	ATM
GCATGGGCCATGCATTTTCTA	CATGAATTGGCATCCAATTACAGATTTATTTTT	78	JAK2
TTCTCTTGCTTACATGAACTCTATGTCG	GCCATGATAGGCTCCTGAAAACTAA	86	ATM
AGAAAACACCCTTATTCATGGGAATGT	CAAAACTGTAATACTAATGCCAGGATCACT	69	JAK2
GCACAGTCATTTTGGAGATCCTGAT	TACCTGAGTGTTCTTGAAAGTTCTGG	79	ATM
TTTTTATCCCTAGCTACAAGACATTCTTAC	TTGCATTGGCTGAATTGCTGAATAAAT	72	JAK2
CATACACAGAATGTCTGAGGGTTTGT	AAGTAACTATCTTAAGGGTTGCTCCAAAAA	71	ATM
CAAAGCCACTGCCAGAAACTTG	GCAAAAATCTCCTCACCTGAAGGA	82	JAK2
ACTCATTTTTACTCAAACTATTGGGTGGAT	GAAAGCAGATTTCTCCATGATTCATTTGT	79	ATM
GGTCAAGAGGGAAACATAAAGAAAGTGA	AGTGCAATACCATGTTGCAAATGATTAAAA	81	JAK2
AGGGATTTTTCACCAGCTGTCTT	TCCATCTTTCTCTAGAACTGAGTTTACAGT	78	ATM
TGGCCAAGGCACTTTTACAAAGA	CCTCTGAATAGTTTCTGTGTGCTTTATCC	72	JAK2
TGATGCACTTCCATTGACAAGACT	ACAGGTAGAAATAGCCCATGTCATTTAAAA	83	ATM
TTTTTCCCATTGACTGGAGGAAATTG	ACGATCATCTGTCCTTGTTTGTCATT	79	JAK2
CCCTGTTATACCCAGTTGAGCT	CACACACTCGAATTCGAAAGTTGAC	86	ATM
GCAGAGTAAAACATTATTTCCACCTTTATGT	TGCAGAAGTTTTATGTGATCTATCCGTT	80	JAK2
GTGTGAATTAGGAGATGAAATTCTTCCCA	GGTTTTGGCTCCTTTCGGATGA	87	ATM
ATCCAGGACATGCGCAGAGA	ACAACACCAAGTCTTTTGAGGACA	95	HRAS
AAAAAGTCTTTTGAAGAGAAATATGAAGTCTTC	TATAAGCCAATCGCTTCTCAAACCAAATA	67	ATM
CGGTGCGCATGTACTGGT	TGTCCTCCTGCAGGATTCCTA	85	HRAS
AAGCAGTCTTTGTTTGTTAATGAGTAATTT	ACTTCATTTACAGGAAAGTCTTTTCCCA	75	ATM
CTGCGTCAGGAGAGCACACA	GGAGTGGAGGATGCCTTCTACA	82	HRAS
TAACATCATTTGCTCCAAACTGACCA	CCAGAGCCAAGCATCATTGAGAA	87	PIK3CA
GGAAGCAGATACATCCACTTCCA	TGCAGTTTTCATGAATTCACTTTGTTCT	88	FLT3
CTGACTTCTGGAATCTTTGAGACCA	GAGGACAGCTGGTTATTCCAGAG	90	GNAS
CTCCTCGAGTGCTTTGTTTTCTAATTC	CTCAGACCACATTGCCACAATTATTTC	70	FLT3
GTTCACTTTCAGGAATTCTATGAGCATG	TTGGGTGGCGGTTACTTACTAC	78	GNAS
GCCTCTTACCTGGAATTTGGATGTG	TGCTATGGTGATCTTCTCAACTATCTAAGA	78	FLT3
GATTTCCTGCAGAAAGACTTGAAGG	TGGCTTAGAAATCTTTTCTAAATGAAAACACAA	81	PTEN
TTAAATTCCAGAAATTCCATTCCTTTGGC	TGGCTCTATTTTACAGATGAAATTGAATATGAA	77	FLT3
TCACTTTTAAACTTTTCTTTTAGTTGTGCT	ACAGTAAGATACAGTCTATCGGGTTTAAGT	68	PTEN
TCATGAAAGAGTCAATAGGTCAGAGAGT	CTCGGATGGATACCCATTACCATC	77	FLT3
TTTTTAGGACAAAATGTTTCACTTTTGGG	CACGCTCTATACTGCAAATGCTATC	76	PTEN
AAATATTGTGGTATTCCAGGCTGGAAT	ACAGAAACCCAAGCTGGAGAATAC	82	FLT3
GTGCAGATAATGACAAGGAATATCTAGTACT	CCCACAAAATGTTTAATTTAACTGACCTTAAAA	65	PTEN
GTGCCAAGGGAATTGTATGCAC	GAGATCACAGAAGGAGTCTGGAATAGA	87	FLT3
TATCTTTTTACCACAGTTGCACAATATCCT	GCTTTACAGTGAATTGCTGCAACA	85	PTEN
GATTTTCGAGAGAAGGTCCACGTA	TTCTTACAGAAAAGGGATTTATAAATGCTACCA	81	FLT3
TTCTGTCCACCAGGGAGTAACTATT	TTTCAAACATCATCTTGTGAAACAACAGT	70	PTEN
GAATCACTCATGATATCTCGAGCCAAT	ACAGTAAATAACACTCTGGTGTCATTCTT	78	FLT3
TTTGTTTTAAGGTTTTTGGATTCAAAGCATAA	TCACTCTAACAAGCAGATAACTTTCACTTAAT	73	PTEN
GGGAAACTGTGCCTCCCATTTT	AAAGTGATGAACGCAACAGCTTATG	87	FLT3
AGTAGAGGAGCCGTCAAATCCA	GCTGATCTTCATCAAAAGGTTCATTCTCT	88	PTEN
CATTTGGAAGTAGACAGACTGTACCT	GTTGATGCTAACTTCTACAAACTGATTCAA	82	FLT3
GAGCTTTTAAGTGGTAGCCATAGTATGA	GTCGTATACGAAGTATGTCCTTTTCGA	84	APC
TGAATCATTGTTCTTATGATTGATTAAAACACA	AGGTGTGCATGTATCAACATTATCATTTTTATT	69	FLT3
TCTTGCTGACAATCATCACCAAGTT	CTGTTACTATGTAAGACATTCTACTGCCAT	69	ATM
TCTTTTGATGACATTGCATACATTCGAAAG	TGTGGAAGATCCAATCCATTTTTGTTG	81	PIK3CA
AGAGTCAGAGCACTTTTTCCGATG	ATCCTAAACGTAAGAAGCAACACTCATTA	71	ATM
TTTCTACACGAGATCCTCTCTCTGAAA	GCTGAGATCAGCCAAATTCAGTTATTTTT	83	PIK3CA
CCTGAAAACCTCTTCTTTATTTTCAGAGTG	GCAACCTGCTAAGTGTGGGATA	75	ATM
TACGTGATGGCCAGCGTGG	CCAATATTGTCTTTGTGTTCCCGG	96	EGFR
GATCGAACAGAGGCTGCAAATAGAATA	CACTGAGTGGCATCTAAGTTTGCTAATATA	67	ATM
AAATTCCCGTCGCTATCAAGGAAT	CTGCCAGACATGAGAAAAGGTG	93	EGFR
TGCCCTTGCAGATTGATCACTT	CCTGAAAAGTCACAGAGGTCAGT	81	ATM
GCAGATTCTGCTAATACCCTGCAA	CAGTCTGCTGGATTTGGTTCTAGG	77	APC
GATCTTGTTATAAGGTTTTGATTCCACATCT	GAATATTTACAAGAATCTTTGGAAAGCAGTCTG	73	ATM
ACTGCAGGGTTCTAGTTTATCTTCAGA	GAACATAGTGTTCAGGTGGACTTTTG	71	APC
GGGTACCAGAGACAGTGGGAT	ATCTCATATCATTCAGGGAATGAAAAGTAC	88	ATM
CTCATGTTTAGCAGATGTACTTCTGTCA	CCAGGGCTATCTGGAAGATCAC	89	APC
TTTTTACCACAGCAATGTGTGTTCT	TGAGCATCCCTTGTGTTCTCAG	87	ATM
CACCAAGCAGAAGTAAAACACCTC	CCTCTGAACTGCAGCATTTACTG	92	APC
TCAGTGAGTTTTCTGAGTGCTTTTATCA	AAGCAAAGTTTTAAGGCAATTTACTAGGG	82	ATM
GATAGCGGGACTGATGTCCA	CCCACGATCTTCGAGGAGAGA	84	JAK3
GTGCCCAGCCTGATTAGGTAAAT	TGATTCTACTTCTCCACGGTCAAATG	80	ATM
CCAGACTGAGGTATCGCCTCAT	ACCCACATCATCCTTGGTTCAG	82	JAK3
CGATTACCCTGATAGTAGTGTTAGTGATG	GAGGCCTCTTATACTGCCAAATCAATATAA	71	ATM
CCACGTTTTCGCAGATACATGT	GCAGAACCTCCTCAACACAAGTG	80	JAK3
ATTTAAGTATTCAACGAGTTTCTGAAATTGC	GAGGCTTGTGTTGAGGCTGATA	75	ATM
GAGATGCCGGTACGACACTT	TCTGTGAGCACAAAATTTGGGATTATTG	77	JAK3
AGACACTTCATTTGGAGTACCTTAACATG	ACTAGAACTCAAAACACTGGCTGTT	85	APC
CAATACAAGTAAGACCCATCAGTGTTG	ATGGAATATTACTGTGGGAAATCTTCTCAC	82	FLT3
AAACAACTACAAGGAAGTATTGAAGATGAAG	CACACCTAAAGATGACAATTTGAGCTTAAAAA	74	APC
TCTTAATGGTGTAGATGCCTTCAAACAG	AGAAAAGAAGTCATGTCTGTATGTGGAAAA	68	FLT3
TTGTGGTTTTAGTTTTCCTTACAAACAGATA	CTGTGCTCGTTTTTCCATATCCTG	70	APC
GTAGCCCTTCTAAGCCATTACTTAACTT	TGATGCCCAATTTACCAAAATGTTCAC	84	FLT3
ATCAGTAACATAGAAGTTAATGAGAGACAAATT	GTGCAATGTGCTGACAAATTCCATA	70	APC
GGCATCATCATTTTCTGCATGGAATATAT	GCAGCATCTCCTGTAGCAATTG	73	FLT3
GCTGTAGATGGTGCACTTGCAT	ACCTGTGGTCCTCATTTGTAGC	94	APC
TTAGGGATAGGTGGAGGGATGAAG	GGAATGTCCTCACACCTACCAAA	92	FLT3
CATTTTTGCATGTACTGATGTTAACTCCA	ACCATTACCAGAAGTTGCCATGT	87	APC
TCCTAATCCCACCTCCTAAAATAATCAAGA	GGGAGCATAATCCACCATCAATATATC	79	BRAF
ATCCCATTCATCACTTAATTGGTTTTTGG	CATATCATCCTTATCATGAGTACCAAGCAT	77	APC
CCTCTATATGTTCCTGTGTCAACTTAATCA	GCAGTTACTGTGATGTAGTTGTCTATGTTA	79	BRAF
GCGAACTTTGCTAGCTATGTCTAGC	GGAATTTCCCAACAATACAGAGTCTTTG	73	APC
TTTTTAAACAAAATTTCACGTCACATACAAACC	TGCAAGGTGTGGAGTTACAGTC	80	BRAF
ACTCACAGCCTGATGACAAGAG	ACTTGGATTTTTGTCCTGGTCCAT	93	APC
CCAAAATTACTCATCCATATTTCACATTCCCT	GGAAGTGTTGGAGAATGTTCCACT	83	BRAF
CCTTTCTTTAAAAACAAGCAGCCACTA	TCTTCAGTGCCTCAACTTGCTT	90	APC
TCCCAACCAATTGGTTTCTTCTCT	CAAACCTCCCTCACTGTTACTAGC	91	BRAF
CTTCGACAAGAGCTAGAAGATAATTCCA	CCTCAAGTTTACAAGAGGGAATACTGAAT	81	APC
AATGAAAAATGGCACTTATTTCTGATCTAAG	TGTGCATATAAACACAATAGAACCTGTCA	78	BRAF
CCTAAGAGAGAACAACTGTCTACAAACTTT	CTTCCTGGTCTTTAGGATTTCTTGCT	68	APC
TGTCTGTTACTTGAAAGAGGCAAGT	TTGTAGGACTTGATTAGAGACCAAGGA	86	BRAF
TGCCATTTATAATGTATTTTTCTTTAAGTGCAA	GCTTTAAATGACTGTATAGTCACCAGATTTCC	65	ATM
GGTCTTGGCTGAGGTTTCAATG	CGGATGATGTACCTATGGTGCTAGT	80	NRAS
AAAGTGTATTTATTGTAGCCGAGTATCTAATT	CTGTGCTTCTTATAAACATTATTTGTTTCAGCT	74	ATM
GGTGGGATCATATTCATCTACAAAGTGG	TGGTTTCCAACAGGTTCTTGCT	84	NRAS
ATCACCTGTTTGTTAGTTTATTACTGAAAGATA	ATTGGTCTAAATATGTTATTTACCTTTGGTTGA	68	ATM
CAATAACACCAGCACTCCTCCAA	TGATGATGGGACTCAGGGTTGTA	85	NRAS
GGTATTTAATCTGTAACTCCAGGTGGTT	TGTATCTTTTATGAGCACCATCTTCATTGT	69	ATM
CATTCGGTACTGGCGTATTTCTCT	GCAAGAGAGCTTATAATTTGGATTGTGTC	74	NRAS
TAAAGGAGCTTCCTGGAGAAGAGT	GCTTAACAGAACACATCAGTTATTTTATAACTT	80	ATM
ATCATCCTTTCAGAGAAAATAATGCTCCT	CAGTGCCATGAGAGACCAATACAT	79	NRAS
CTTAAAAACAAAATAACTCCTGTTTAGGCCT	TAATGAAGTTCTTCTAGTTCAGGACACCA	67	ATM
TCTTCTTGTCCAGCTGTATCCAGTAT	GGTTTTTAATAAAAATTGAACTTCCCTCCCT	79	NRAS
GGGAGAAGTGGGTCCTATAGATTTCT	GTGTGTTATTCAGGTAGGTCAGCAT	88	ATM
CTTTCCAGACACTACAACAACAGGA	GAGTGACTATTACTGAGCGGAATATTGAT	85	PTPN11
TATTCCCAAGGCCTTTAAACTGTTCA	GCCTTCTTCCACTCCTTTCAGTTT	89	ATM
GGGAATACGGAGAGAACGGTC	CATCCATGATGCTCTCCTGCTT	86	PTPN11
GTGGACAAGTGAATTTGCTCATACAG	TTCTAAAGGCTGAATGAAAGGGTAATTCAT	69	ATM
TTATCTTGAAAGGAACTGAAATACGACGT	AATCTGCTCACCTGCTTGAGTT	88	PTPN11
AAGGCAAAGCATTAGGTACTTGGT	CCATCTTGTCAAAAGTTGTCTGAAGAAAT	83	ATM
TGAATGATTCTGTTGTCCCTGCTT	GCTTCTTGCCCACCAGATGA	91	PTPN11
GAGAATGTGGTATAGAAAAGCACCAGT	CCTCAGATGAGTAATTATTCAGAAGCTGTT	68	ATM
CTTCCTAAATTTCTAGCCTGAATTTGAAACC	ACTCGGGAGTTTTCTTGGAACAC	83	PTPN11
TTTTTAATTTCTTTTTAAGTCCCATAGTGCTG	TGTTTTTCGCAGATAGGGCTACA	73	ATM
CCCTTAAAATAACCATTGTCCCTCACAT	CGGGAGAGGGCTCTGATCTC	84	PTPN11
GCAGCTTTAAGGAATCTCATGGCA	ATAAGTGCTGAGCATCTAATTCTGCTT	87	APC
AAGACATTTAACGAATGGAACTTACTCCAT	GTGAGGGCTCCAGCTTGTATC	73	BRAF
ACAATATAGACAATTTAAGTCCCAAGGCAT	TGTTGCCAGTATTAAAATTGTCTGACCTAT	74	APC
CCTCACACCACTGGGTAACAATAG	GTTTGTCGACATTTAATGTTTACTGTCACA	71	BRAF
GCAACATGACTGTCCTTTCACCATA	AATTCCGCGTTCTCTCTCCAAA	77	APC
GGGCCAGCAGCTCAATAGA	CACCCAGATTTTCATTCTTCTTTCTGTTTT	78	BRAF
GCAACTACCATCCAGCAACAGAAA	CTGTCTTCCTGAGAGGTATGAATGG	80	APC
GCCTTCTGCATCTGTGATCATCA	GGAAATGGGTAGGATACTCTTGGGAA	88	EGFR
ACCACTGAATTACATTGTGTGACAGAT	CTAATTTGGCATAAGGCATAGAACATGTC	82	APC
GGAAAGGGCGTCATCAGTTTCT	CTTACGTTTCTGGCAGTTCTCCT	93	EGFR
ATGGTAAAAGAGGTCAAATGAAACCCT	TCCATCATTATCATCCATATGATTTGCACT	82	APC
GGTGTCTGTCCTGGGAGTCT	GCTTGAAGAGCTCCTCCACAG	95	FGFR3
CAGATGAGCAGTTGAACTCTGGA	TGTACTTTGATTCCTTGATTGTCTTTGCT	72	APC
TACCTCTGTCGAGCCACCA	CCTTGGAGCTGGAGCTCTTG	85	FGFR3
ACTTATCCTGTTTATACTGAGAGCACTGA	CACTCGATTTGTTTCTGAACCATTGG	70	APC
ATGCCTCCCACGAGGACT	CGGCTCCTTTCTGTAGCTGG	86	FGFR3
CGAGTGGGTTCTAATCATGGAATTAATCA	TCTTCATGCTGTTCTTCTTCAGAGTAAC	67	APC
ATGAAAAACCTTACAGGAAATGGCT	TGGCAGTTGAGAATAAAGGCTTTCTT	75	PIK3CA
GTCATGTGGATCAGCCTATTGATTATAGT	GAAGACATATGTTCGGTTTTACTGCTTTG	68	APC
GAATCCGGAGGGTCACCAA	GGTCCCAGTCTGCAGTTAAGG	95	CDKN2A
GAGTAGAAGTGGTCAGCCTCAAAA	AGCTGATGACAAAGATGATAATGAACTACA	84	APC
TGTAGGACCTTCGGTGACTGAT	GGATGTGCCACACATCTTTGAC	95	CDKN2A
CCAGATGCTGATACTTTATTACATTTTGCC	TGAACTGGAGGCATTATTCTTAATTCCA	81	APC
CCGCCAAGTACCTCAAGTTG	GCTCACGCTGACGGAGTA	89	NOTCH1
GCCCTGTGTAAATCTGTGAAAGAGA	GCCACTCAGAAAATCTAGCTTTAACTTTTT	84	ATM
TTTTTGCATTAACACCGTTTTCTGT	TTGCTTAGTTCTCGAACTCTGCTTT	77	PTPN11
GGTCTTCTAAGTGAAGCTTTTTGTTTTTCT	TAACATACCATTCTGGCACGCTTT	85	ATM
AAGCAAATTAGCTGAGACCACAGATAAA	AGCAACTTCTCCTCCACTAAAAATAGGATATA	64	PTPN11
GTTCTGTTAAAGTTCATGGCTTTTGTGT	TTTACATAAGAAGCGTTTACGATCCTCTT	82	ATM
TGTGAAAGAACAACATGAACCCATAGT	CAAGAAAACTACCATGTTTTCCTTTTTCAGTTA	79	PTPN11
AACTGCTTATTAAGTGGAGAAGAACATGA	AGGGTAGAATATTGGGCTGAGTAACA	77	ATM
CGCACTGGTGATGACAAAGG	AAAAATCACCCAAAGGTAACATCTTGC	79	PTPN11
GCTTCCAAATAGTATGTTCTCATTAAAAGAGGT	ACCTGTAAACTTATTCCAGTTTCTTCTTTACTT	73	ATM
AGTTGATCATACCAGGGTTGTCCTA	TAGAAATGTATGGTCAGAAAACACTGTGAA	69	PTPN11
TTTTTAAGAATTGTTCTCTGTGTACTTCAGG	AATCCGTCAGTCTGAGAACAGC	72	ATM
GATGTTTCCTTCGTAGGTGTTGACT	TTTCAATATAATGCTGGACCGCCATAT	86	PTPN11
TTAGAGAAAGTTTCTGAAACTTTTGGATATAGA	AAAGGAAAAGAAGATAAGTTGTATTCAGTATCT	61	ATM
TGCCCAAAGAATGTAGTATGTGTTTTATAGA	AGGCCCACGTTTTCATAGACTC	86	PTPN11
TGTTTGTCTTAATTGCAGAAGAGTCCA	AATATGATAGCAAAACAGGAAGCATACTTA	81	ATM
GCCTCCCTTTCCAATGGACTAT	ATACTGGACCAACTCAGCCAAAG	84	PTPN11
ACCCACTGCAGTATCTAGACAGT	GGGTGATCCATTGAAATTCTAGAGATT	89	ATM
TAAGATGGTTTCACCCAAATATCACTGG	CAACTTACCTAACGGAAAGTGTGAAG	80	PTPN11
GCAAACAGAGATGAATTTCTGACTAAACC	GACTGAATATCACACTTCTAAAAGGTACGT	80	ATM
TTCCACAGCCCATCACGAGGT	ACAGCAAGTCAACTCAGGAGTG	89	JAK3
CCTCAATGAATGGTAGTTGCTGC	ATTGTACTGTTTAATTTGAAATATTGCCCTT	83	ATM
GGCAGGTACTCCATGACCAG	GTCGAGAGGGACACAAGGTCC	89	JAK3
CAATTCAGTTAGCTGTGGAGTCTCT	ACAGCTGGCATCCAACTTCT	81	ATM
CCAAACCACTCCTCAGCCTTC	CCGCCTCCTTCTCTATTCCTC	88	JAK3
GAATCAGAGCAGCCTAAAGAATCAAATG	GGCATGGCAGAAATAATACATTCTTCTAGT	81	APC
GGCCACAACCCTTACCCTA	GGCTACACAGGCAGCTACT	99	NOTCH1
ATGCCAACAAAGTCATCACGTAAAG	CAACCTGTTTTGTGATGGTAGAAGTT	74	APC
GGAGCACTTGTAGGTGTTGGG	CGTTCTGTCGCCTGCACA	93	NOTCH1
TTGTGTTGAAGGGACACCTATAAACTTT	TATCTCGTTTTTCAAATTCACCTGACTGT	82	APC
CAGGGCACTTGCAGATGAAC	CTCTCACTGCCCTGCTCTTAC	96	NOTCH1
GATAATGGACCAGGTCCAGCAA	CACGTGTCCTATATTCAGTATTTTGTGGT	79	APC
CGTCGTGCCATCATGCATG	CGTCCAGGCGTTCGTTCT	98	NOTCH1
AAAAATAATTTAAATGCTGAGAGAGTTTTCTCA	CTTCCTCTGACTCTATCTTCATTATTTGGG	61	APC
GGCTGTGAGTCGCACTCAT	CCTTGCAGCTCCTGCTTCAA	85	NOTCH1
ACTCCTTACTGTTTTTCACGAAATGATTCT	CTGGTAACTTTAGCCTCTGATTCCTTATTT	73	APC
CGGTCTGTCTGGTTGTGCAG	CGCTCATGATCGCCTCCTG	87	NOTCH1
GCAACTGATGAAAAGTTACAGAATTTTGCT	GCTCAGTCTCTTTGATAGGTTCATTTTCTT	78	APC
GCAGACACTGGCACTCGAA	GTGTGCAGTGAGGTGTTGC	97	NOTCH1
CTGACTCACAGGGAGAACCAAG	ACAGGTCATCTTCAGAGTCAATACTAAGA	86	APC
CTGGCAGGCATTTGGCATC	ATTGCCACCCTGCGTCTTA	96	NOTCH1
GCAGGAATGTATAAGCTCCGCAAT	ATCTTTCAAATCAAGTGTCAGATCTTCAC	76	APC
GGGACACTCGCAGTAGAAGG	CAACTGCGTGTGTGTCAACG	89	NOTCH1
GACCAGATTCAGAACATGGTCTATCC	AGCTTGTCTAGATAAACATGCAGCA	79	APC
TTTGGCCCTCACTTCTCTGTG	TGTGGATGCCGCAGTTGT	87	NOTCH1
ACAAGCTTCGTCTGATTCAGATTCC	AGAATTCGTGGGCCTTTATTACTTGT	74	APC
CACCCGGAACTTCTTGGTCT	GCTCAGCCTCACTTCTCGA	85	NOTCH1
GGGAGAAAAGTACATTGGAAACTAAAAAGA	ATTTGGCCTGAAATTTCTGAATTAGATCG	67	APC
CAGACACAGGAGAAGCTCTCAT	GGGTCACGTGTGTCTCCTT	87	NOTCH1
TCATTTTTCTTTAGACCTTCTTCAGGAACA	GCATAGAGTAAAGCTGTAAAGTGAGCA	67	ATM
CAAAGAGGTGCTCCAGGACTG	ATCCCAGGGTTCTCTCCTCTC	92	JAK3
GAGAAAGTAGTGATGAGCTAAGAAATGGAA	CTTGCTTGTTTTCAAATTCCGATGATTTC	66	ATM
GGGACATCCCGCTCACAT	CCGCTCCATCACAGATGGC	101	JAK3
GGTAGAGAGACGGAATGAAGATTCC	TTTTCAGGTTTACTTACATTATTGAGGACTTCA	77	ATM
GGCTGCAGCTTTTGTCGC	TCGCATCTCAAGACCTTGTCC	100	JAK3
GCCTTCTTGTATCATGGATGTGTCATTA	ACAATAACATGAAGATGGTTTTCTAGAGCA	67	ATM
CACTCACCCTGCTCCTTGAG	GTTAACAACAGGGCTTGAAGTTGG	81	JAK3
CCCTTTCTTTCTAGTTTTTAGAAGTACCCA	CACAAGTCAGTGTCTTTATCCAAATGT	71	ATM
TGGACAAGAGGCTGCATGAAC	CTCCCTGCTCAGAAGTCCAATC	95	JAK3
TGCTATTCTCAGATGACTCTGTGTTTTT	GTAATGTATTACACATCTGGAAGACCTGT	82	ATM
GTCCCAGATCAGCCACTCATT	TTCGAGAGCTCCTGGCAAC	94	JAK3
CACGGAAACTAGGAAGAGGAAATTAACT	ATTATGAATATGGGCATGAGCCACTT	76	ATM
CCCTCCTATTCTTCAGGAACCAAATG	CTTTGACAGCTTCCTCCTCACT	91	JAK3
CTCTCTGTTTAGGTCCTTCTATATGATCCA	TTTGCATTCTTGGTCATCTGCATTC	82	ATM
ACATAGGAGCCAGGACGTGA	GTACCTGAATTTGAGCCCAGGT	93	JAK3
AGTATGTCCAAGATCAAAGTACACTGTAAA	CAGAGTGATACTTTCTCCTGCACATT	68	ATM
TACTACAGAGCCCACTCCCAAT	GCTGCAGGTGGTCAAACAG	88	JAK3
AGAAATATGATGCAGCTATGTACACGT	ACAATGAGTTGTGACAATCCCACT	88	ATM
TCAGGCCCTGGATCAGGTCG	CTAAAGCCTGGGTTTGTGTGTG	88	JAK3
ACAGTAAGTTTTGTTGGCTTACTTTAAAAT	ATCGTGATATAGAGGTTTTCATTATCCTTGTT	74	ATM
CTCCGTGGCCAGAGCAAAGAG	GGACGGTTGGGTATGATGCTG	84	JAK3
TTTTAAGGATTTGCGTATTACTCAGCAAAAA	GCATTACAGATTTTTGAAAAGTACTACTATGTT	73	ATM
GGGCCTGCTTGATGCTAATGT	GGGTTCATGGGCGTGGTTT	84	JAK3
GCAAACATGCCTTCAATCTCTCGA	GCTTTTGGAGGCTGGAGTCTTAAG	77	APC
TTGTCCACAGGCGAGGAGT	CCTGGCGGTGCACACTAT	100	NOTCH1
CCAGGCAGACATCCCAAATAGG	GTTTCGGCCAGGAGACTGTATAG	79	APC
GCTCTGTGCAGAATCCTGTCT	GGGCTGGACAGTGTTGAGATAC	81	EGFR
TCCTCCTAACAAATTATCTCAACTTCCAAG	TAAGGTTCTGTTGGCTCATCTGTCTA	68	APC
AGTGAGCCAAGGGAGTTTGTG	AATGGACGTGGATAGCAGCAA	82	EGFR
CTGCCTCCAAAGGACTAAATCAGAT	GTTGACTGGCGTACTAATACAGGTC	88	APC
AGGCTGGATGATAGACGCAGATA	CAATGGAAGCACAGACTGCAATT	81	EGFR
GCTCCAAGCCCAACCTTAAGAA	AGGGAAGGACTTAAAACTGGAGTTTG	76	APC
TTCACCACATGATTTTTCTTCTCTCCA	TTTCCTGAAATTATCACATCTCCATCACTT	74	EGFR
GTCTCTATCCACACATTCGTCTGTT	TTTCAGAATGAGACCGTGCAATATCA	79	APC
GAATTCGGATGCAGAGCTTCTTC	GGTGTTTTCACCAGTACGTTCCT	93	EGFR
AGTCCTTCTAGACTTCCAATCAATAGGT	GGATTCTGATGAAGCAGAAAGAATTGAAG	80	APC
CTTAATCCAACAAATGTGAACGGAATACA	CTGATGGAGGTGCAGTTTTTGAAG	86	EGFR
GCAAAAAGTGAGGATGAAAAACATGTG	GGTCTGAGAAGTACTATTTGTGGGAGA	83	APC
CATTCATGATCCCACTGCCTTCT	CTTTCTCCAGGATGGAGGAGATCT	83	EGFR
GCTACAAATGGTGCTGAATCAAAGA	GGAGTATTACCTGTGGGAGATCTTC	89	APC
CACCCATATGTACCATCGATGTCT	TGACATTTCTCCAGGGATGCAAAG	90	EGFR
CAGTGTTTCAGAAAAGGCAAATCCAAA	GGGCATCCACCTGAATAAAGGA	90	APC
GCCCTGATGGATGAAGAAGACAT	GAGAGAGACAGAGATTTCATACCAGAGA	87	EGFR
TGAGATAAAACCAGGACAAAATAATCCTGT	GCAACAGTCCCACTAGGTGAAC	73	APC
TTCCAAGATCATTCTACAAGATGTCAGTG	GGCGATGGACGGGATCTT	91	EGFR
CCTAGGAAAAGCAGCGCAGATAG	GGACTTTGGGTTCCACTGGATTC	78	APC
GACCTTGAGTTCTTGAGTTCCTCAA	TGATCTGCAGGTTTTCCAAAGGAAT	88	EGFR
ACGAAAATTCCTATGCCTTAGCAGT	CTGCTGTCTGCATTTATGAACCC	87	EGFR
CGGCCTCGATCTTGTAGGG	CATCGTCTACCTGGAGATTGACA	97	NOTCH1
TTGCCAAGGCACGAGTAACAAG	TCATAATTCCTCTGCACATAGGTAATTTCC	82	EGFR
CAGTGTGTCAAACAGTATTCTTGAATGTT	GGGATCTTCACGGTAACTGAAGATG	72	MET
GCCATGTTATTCTGCCTTTTTAAACTATCA	GCTGAAACTCTGACGGCAGAA	87	EGFR
ACATTTTGTTTGTTCGTTTTCCATATATGTGA	GTCAGCCTTGTCCCTCCTTC	73	MET
GCAAAGCTGTCCCATCAAGGAA	AGCAGGACTGTTTCCAGACAAG	92	EGFR
GGGACTTTGGATTTCGGAGGAATAATA	AGCATTTTAAGATCCTTACGTATTCATCGT	67	MET
ATTAGGTCCAGAGTGAGTTAACTTTTTCC	TCTGGTGGGTATAGATTCTGTGTAAAATTG	79	EGFR
CAGTGGTGGGAGCACAATAACA	CTGAGTAGAACCATTGCTCAAAGGA	85	MET
TCCAGTGTGCCCACTACATTG	ATGGCACAGGTGGCACACAT	83	EGFR
CTAGGCATGTCAACATCGCTCT	GAGATCAAAGTATTTGGAAAGGATCCCAT	87	MET
CCCTGGGAAATGATCCTACCC	ACTGGTTGTGGCAGCAGTC	97	EGFR
TCCTGTGTTTAAGCCTTTTGAAAAGC	GCTATGAAGTCAATTAAGTTTGAGCTGATG	73	MET
GAGAGCGACTGCCTGGTAA	TCTGTTATGACAAATGCTAATTGACAGCT	82	EGFR
CTTGTTCATGTCTGGATTCACATTAACT	GAATAAGTCAACGCGCTGCAAA	89	MET
TGTCTCCGCAGAGGCCACA	GTTGCACTTGTCCACGCATT	93	EGFR
TCAATTCAGCGAAGTCCTCTTAACA	GACACAGCTACTCTCAGAAAGCA	76	MET
AAAAATGTTAGTGGTCATTTTTCTAATGTCTT	AAAGGGAGAAATTGAAATTGTAGAAAGGAAATG	61	EGFR
CCCTTCTCTTCACAGATCACGA	CTCCGATCGCACACATTTGTC	91	MET
CATCACCTTCCTTTCATGCTCTCT	CAAGGCCCTTCGCACTTCTTA	94	EGFR
TGTGGTAAGGAAGATTCTATCCTATCATGT	GGACCGTATTTCGGCGAAATACT	86	MET
TATTGATCGGGAGAGCCGGA	ACGCCCTTACCTTTCTTTTCCT	97	EGFR
GGCACTTTACTTACTTTAACTGGAAATTACCTA	ACAGATATTAATTCAAATTGACAGATGCAACAA	73	MET
TCTGAAAAATACAAAGAAACAGCAAAATGGT	CAAAATCCCACAGATGTGGCAC	86	BRAF
CTGCTGATCCTGTCTGATGTGAAT	GCTGTGAAGGGAGATGTATTGGG	92	CDH1
AAAAACTGAAAGAGATGAAGGTAGCACT	CCAACAAAGAGAACAACAGTTATTGGAAT	81	BRAF
GTGCCAACTGGACCATTCAGTA	GAAGTTGAGAAGGGAAATTGAAAGGTG	76	CDH1
GGGATGATCCAGATGTTAGGGC	GTTTTGCACAAGTTAGGTTTGTTTTGTTTT	78	BRAF
GGGAATGCAGTTGAGGATCCAA	TGGATATACCTGGAAGAGCACCTT	80	CDH1
TTTGGATTACTTACTCAAGTTGGTCATAAT	GCATTTTGTGACTTTTGTCGAAAGCT	82	BRAF
GCCCTCAGCTGATGTCTCCT	CTTCCTCCAGAAGCTTGAACTCT	94	SMO
CCATTCGATTCCTGTCTTCTGAGG	ACCACAGGTTTGTCTGCTACC	87	BRAF
CTGGCCCTTCCCAAGATTTGAT	GGCAATCATCTTGCTCTTCTTGATC	81	SMO
CCATTAATCTCTTCATGGCTTTTGGAC	TTTTCAACTTATCTACAAGGTTGAATTATTTCC	79	BRAF
CCTTCAGCATGCACACTGTG	CGGTCTTCCAAATAATCTGTGTGC	95	SMO
TGTCCCTTGGATACAATGCTAAAATGA	CCCATCTTTGGGCTTAATTTACATGT	85	NPM1
CCCTTCTGTTCAGGAGTCATGA	GGACCTCAGACCGAAGTCC	98	SMO
AATTAGCTTTATAAGGGAGTTTTGTGAGAATAT	CTGTTTCTTGAAGGATTCTTGTCCC	80	NPM1
GCTCAGTTAAGGGTGTCTGTGT	ACGCATTGACGTAGAAGAGAATAACAG	90	SMO
CGGATGACTGACCAAGAGGT	GTTAGGAACTTTTTAAAAAGAGCCAACACTTAA	71	NPM1
GGCCCAGTTCATGGATGGTG	CGCACACTTCAGCCTTCCTC	90	SMO
CTTCATTTACAGGTTGTGAACTAAAGGC	GGCTGAAATCAAGTAGGGTTAAGTAGTTTA	81	NPM1
CTCCACAGGCATTTTTGGCTTC	CCCTCACTCACAGCACATAGTC	83	SMO
GGGTCAGGGACAGTGATTAAGATAAA	CTTACTTTTGATCTTGGTGTTGATGATGG	75	NPM1
CATCCCTGACTGTGAGATCAAGAA	CCAGGTACGCCTCCAGATGA	94	SMO
AAATGTCTGTACAGCCAACGGTAA	CAGTGACAGAAGATAAAGAACCACTTTCTA	83	NPM1
TGTGGTTTGGTTTGTGGTCCT	TTGCCACAGTGAGGACAAAGGG	96	SMO
GTGTCCTCTCTCCTCCATAGGT	CACCAAAGCTGTATTTGCCCT	94	EGFR
GGTTTCTCGATCAGGACCATCAAC	CTTCCCAGTGATAACCAGTGTGTAG	77	MET
CGTGGTGTGTGTCTGAAGTCTTT	TGGTCAACTTACTGTTGCTTGGT	93	EGFR
TAATGCTAAAATGCTGGCACCCTAAA	ATAAGTAGCGTTCACATGGACATAGTG	71	MET
TGCTGGTGGAAGTCAGAACG	CTCATGGACGCGTTGGAC	100	FGFR3
CAGAAGATAACGCTGATGATGAGGT	CCTTTTAAAGGTCAGGCAGTGAAAAA	81	MET
CCAATGTCTCCGAGCTCGA	ACTGGTGGCTGTTTCACCC	86	FGFR3
TGGCTAAATGCTGACTTTTCTTTATTTGTC	TGCTGTTGATATTGAGACAACACCA	84	MET
GCCAAGCCTGTCACCGTA	TTGTCAGTGGCATCGTCTGT	96	FGFR3
GTCTTTCAGTTTTCTCTTCATTTCTGACAA	CTCTGCACCAAGGTAAACAGGA	87	MET
CAACTGCACACACGACCTG	CCGCCTTATTCGGGAACAG	86	FGFR3
GTGAATATGAAGTATCAGCTTCCCAACT	CCTTCTGAAGGTCTTCCTCATTTAAAACAT	74	MET
CAGCGACGTGGAGTTCCA	CCCACCTTGAGCACGGTAAC	93	FGFR3
CAGATTGTTTCCCATGTCAGGACT	GCCACAGCTAATGAGTTGATCATCATAG	72	MET
CCCAGCCTCGATCTGTACC	TCGGCCTCCACACTCTCAC	90	FGFR3
CAGTCGGAGGTTCACTGCATAT	GTATTGCCTACAAAGAAGTTGATGAACC	86	MET
GGTCATGCCAGTAGGACGC	TCTGCAGGACACGTACACG	101	FGFR3
TTCTTATTTCCCAGATCATCCATTGCA	GGTAAGAATCTCTGAACTCAGGTAAAACAT	70	MET
GCTCTCTCTTTGTAGACGGCG	GCAGAGTGATGAGAAAACCCAATAG	93	FGFR3
CCCATTAAGTATGTCCATGCCTTTG	GGAATGCAATCCAGAGTTTATGGAACA	82	MET
CTGTACGTGCTGGTGGAGTA	GACACCAGGTCCTTGAAGGTG	95	FGFR3
TGCCTCTGGAGTGTATTCTCACA	GGCTCCTATTTGTCTAGCAAGCT	78	MET
AGCTAAAGGTGAAGATATATTCCTCCAATTC	TTTGTGGAAGAACTCTACTTTGATATCACC	63	PTEN
AACCAATGGATCGATCTGCCAT	ACCCTATTAAAGCAGTGCTCATGATT	90	MET
ATTTTAGCTGTGGAGGAAGATGCA	ACCTATAATAAAATTGCCATCTCTACCTGTG	84	NPM1
TCTGTGGGTCAGAGTGAGGAG	CACCCGGTCATTCTCACACT	98	SMO
CATGTTTAGTGATGAAAAATTTCTCCCTTCT	AAAAATAACATACCTACTAAGTGCTGTCC	79	NPM1
CCTGACCGCTTCCCTGAAG	CTCCAGGAGACAAAGCTCTGG	92	SMO
AGAATAAAACACATACAAGTTGGAAATTTCTGG	CTTGTGAGTGGATGGGTAAAACCT	82	IDH1
TACCGATACCGTGCGGG	TACTGGCAGCAAGTGCCCAG	101	SMO
GATATTTTTGCAGATAATGGCTTCTCTGAA	TCACTCCTGATGAGAAGAGGGTT	71	IDH1
ATCCATTTCTGCCCAGTGCA	AGGCTCAGAAGTCCGAGTCT	91	SMO
CAACATTATGCTTCTTTATAGCTTCTGCA	CTATCCATTTGTCTGAAAAACTTTGCTTCT	73	IDH1
CCCAGTACCATTCCTCGACT	GCTCTGGGCAGAATGGGTTG	89	SMO
AGCCAGCCTCAATTGTCTCAATAG	CCTCTTTTAGCTTCCATTTTTGCCTG	79	IDH1
ATCCCTGGTGCCAGAATGAG	CGGGTTCTGGCACTGGATG	97	SMO
TCTCTGGTGAGAAATCAATGTAAACACC	TTTGTCCAGATGGCAAGACAGTAG	87	IDH1
GAAATCAAAGAACCTGTGGCCAAA	GGAAAAGAACGGCAGTAAATACGG	85	FGFR2
ACTTGTCATATATCTCCTGAAAGATGTCTTTAA	GATTTTGCACACAGTTCCTTCCAAAT	70	IDH1
GGCTGGGCATCACTGTAAAC	TTTCTTCCCTCTCTCCACCAGA	87	FGFR2
GGAGGTTTAACATTCCAAGATTTTACAACA	CGTGCAGTCGGACTCTGT	90	IDH1
GAGGTATTACTGGTGTGGCAAGT	GGATTCCCGTGGAGGAACTTTT	93	FGFR2
CCGAAGGAGGCACTTACACATT	ACACGAGCCACAACTTTAAAAGAATAAAAA	83	KIT
AAGTGAAGATCTCCCACATTAACACC	TGAGGAGGTGTTTATGTCTCAGCT	76	FGFR2
GTATGACATAATGAAGACTTGCTGGGAT	TTCTATGCCTGGCCAGGGTATA	82	KIT
CTCTTTATCTACTTTCTGTTACCTGTCTCC	GCCTGTATGGTGGTAACAGTCATC	84	FGFR2
CCTGACCTTTATGGTTGTAATTGCTAAGA	GGTAAGAAAAGCTCAGCAAGTCTTCTA	83	KIT
CCTATGCAGTAAATGGCTATCTCCA	CAGTCTGGTGTGCTAACTCTATGG	80	FGFR2
GTGTAATGATATGTGCATATTTATTACATCGG	ATCCAGGAAGAGGAAAGGAAAAACATCAAAAA	74	PTEN
ACAACCTAACCAGAAAATTCCTTGGAT	CGTGGCCATTTGAAATAATTATGGACATAT	74	MET
GACCTGTTTACACGTTCATGTGC	GAACACCAAAACATTTTAAACAGAGAAAACC	83	PIK3CA
CCTTTCAGGGAAATGATATTGACCCT	GCTGTTCAATTTCAGCAGGTCATTG	88	MET
CCTCTTTCAGAATGTTACCTTATGGTTGT	GAACTGCAGTGCACCTTTCAAG	79	PIK3CA
GTGTATATCATGGGACTTTGTTGGACA	GCTATTTATTAGGTTGCAAACCACAAAAGT	72	MET
CACCTAGGTCCTAAAATATGAACAATATTTGGA	GGGAAAATAATTAGACTTACTTTAAATGCCAA	65	PIK3CA
GCCACTTGTTTAATCTGTAGATATTCAGCA	CATGTCTCTGGCAAGACCAAAATC	85	MET
AACTTTCTCAGTATTTAATTCAGCTAGTACAGG	AGCATAAAACTAGTTAGTGCAGTAGGTTTT	74	PIK3CA
GTGTACACAACAAAACAGGTGCAA	GTAAAAGAGGAGAAACTCAGAGATAACCAA	75	MET
CCCGAAATTCTACCCAAATTGCT	ACAATTTAAGTGACATACCAATTTGTACAACAG	68	PIK3CA
ACAGATCAGTTTCCTAATTCATCTCAGAA	GACAGTATTTTGCAGTAATGGACTGGATAT	69	MET
TCCCTTGAAAAATGAAAGAGAGATGGT	CATGGTTGATTTTCAGAGTATACTTCTGCT	75	PIK3CA
CAGTGCAGCATGTAGTGATTGG	CCAAAGATAAAATGCTTACTGGAAAATCGT	74	MET
TGTGTACCAGAACAAGTAATTGCTGAA	ACATCCACACACTTTTAAAATATACTTGCC	71	PIK3CA
TTTTACTAGTGGTCCTTTGGCGT	GGCAGTATTCGGGTTGTAGGA	91	MET
TTCAGATTTACGGCAAGATATGCTAACA	GGATAACTTTCAACATACAGGTTGCCTTA	67	PIK3CA
GAACAGTAGATGCTTAGTTTATGCTTTTCT	AAACTTTTTGCTTGCAAGATATTTCATGC	66	MET
GTGGTTGAATTGGGAGAACCCA	AGATAGCTAAATTCATGCATCATAAGCTCATTA	71	PIK3CA
TTTTTACTGTTCTTCCTCAGACATTCA	CTGGTGGAAGCATACTGCAAAATATT	79	RB1
TTTTTAATCAGGTACAGATGAAGTTTTTAGTTG	CCCAAGAAAGTACCTGAGGTTTC	74	PIK3CA
CTCCCATACCCTCTCAGCGTA	CCATAGGGCATAAGCTGTGTCA	94	ERBB2
CCTAGTAGAATGTTTACTACCAAATGGAATGA	AGATTCATCTTGAAGAAGTTGATGGAGG	78	PIK3CA
ACTAGATTATGATGTGTTCCATGTATGGC	AAAAACTTACTATGGAAAATTACCTACCTCC	76	RB1
CTTTCCTCGCCTCCAAGAATGT	CATTTTAACTATGGCTCTAAAATGCTCTGT	73	KIT
GATTCAATCAAACTGCAGAGTATTTGGG	CAGAGATGGAGATGATGAAGATGATTGG	72	FGFR2
CTGGAATGCCGGTCGATTCTAA	GGGAAAACGTGACCTAAAGGAAAAATTTTT	72	KIT
CCATGAAGTACCAAGTTTCACTGTCTAC	GCCCAACAATAGGACAGTGCTTATT	71	FGFR2
GGATGAGGAGGTAGAGCATGAC	AAGAAACTCCAGGTTTCATGTCCAT	82	KIT
CCCATCCTTAGTCCAACTGATCAC	TTCTGCAGAGCCACCAACCAAAT	79	FGFR2
GGTCATTACAGAATATTGTTGCTATGGTGA	GAAGACTCCTTTGAATGCAGAAGATTC	80	KIT
ACAGTATATACCTGGCAGAACTGTCAA	ACGGACAAAGAGATTGAGGTTCTC	86	FGFR2
GCTCCTTGTATGGGAAAGAAGACAAC	GAATAAACCTCAAGTCCTTGGGAAGA	73	KIT
CTTAAACTCCTTCCCGTTTTTCAGC	CTGGACCAACACAGAAAAGATGGAAAAGC	78	FGFR2
GCTCTGTCTGCATTGTTCTGTG	AGAAGTCTTCTTTAGATAAGTGAGTTCTCA	86	KIT
CGACTTACATTGGTGGTCTTTTTGTAATAG	TGATTTCAGTGTATTCATCGAGATTTAGCA	79	FGFR2
GGATGTGCAGACACTAAACTCATCT	AGAAGTCTTGCCCACATCGTT	86	KIT
TCACTTATCTCTTGGAAACTCCCATTTTG	GCTCCTCCATGAACTCCAACAC	88	FGFR2
TGTAGAGTACACAGAAGATGGAACTCA	CCTGGACTCACAGATGGTTGAG	76	KIT
CAAGTCCTTGAAGGTCATCTGCT	CAGGGCCTCTCTATGTCATAGTTG	92	FGFR2
ACTGAGTGGCTGTGGTAGAGAT	ACATCATGCCAGCTACGATTACG	91	KIT
GTCTCCCAAAGCACCAAGTCTT	TATATAGGGCAGGCCAACCAGTCT	88	FGFR2
TGGATGGCACCTGAAAGCATTT	TCTAATGAAGTTGTCTTTGGCAAGGAT	79	KIT
TGTTCCTCAAACTTTACAGAGGAGAATG	CATCCCGAGCTAGGATGTGAAG	75	CTNNB1
ACTTACGACAGGCTCGTGAATG	TGCATTATAAGCAGTGCCAAAAATAATCAT	80	KIT
ATCAGAGGACTAAATACCATTCCATTGTTT	GTAACCCTATTATGGTCCCTAATTTTCTGA	75	CTNNB1
TTTTGTCCAGTAGTTGTAGATAATGGTTTCTT	ATTCAACAATCAAATCTACATTTTCTCCATCG	75	KIT
AGCAGATGTGTACATTGAAGTCTCAG	GCTCAACTGAAAGCCGTTTCTTG	90	CTNNB1
TACTCAAGAAGCAGAAAGGGAAGAATTTTT	ACCAATTTCTCGATTGAGGATCTTTTCT	77	PIK3CA
GAGGCAACTGCTTATGGCTTAATTAAG	CAAAAAGCACAACTGGCAAACTG	74	KIT
TTTTTATGGCAGTCAAACCTTCTCTCT	GACATATCTGGGAACTTTACCACACT	73	PIK3CA
TTTGTTCTCTCTCCAGAGTGCTCTA	TTGTTTCCATTTATCTCCTCAACAACCT	79	KIT
GCATGCCAATTGGTCTGTATCC	GGATCCTTTTCCATAGAGAAAGTATCTACC	86	PIK3CA
CGTCCTCTTGCTCCACTTCAAC	CCCAGACAGGCAATAGGTATGG	86	RET
GACTGTTTTACAATGCCATCTTATTCCA	CGTAGGTTGCACAAAGAATTTTTATTCTGA	74	PIK3CA
GATATCTACTGAAATAAATTCTGCATTGGTGC	CCAAAGGAATGCCAATTTAATTATTACATTTGA	68	RB1
AAAAACATGTTCATGCTGTGTATGTAATAG	CGGAAGTCCTGTACTTCTGGATC	75	PIK3CA
CTGTTTCAGGAAGAAGAACGATTATCCA	TGTCATTCAGAAGTTTGCTAAAGGAAAAA	80	RB1
ACTTCCGAAGAAATATTCTGAACGTTTGTA	GTGCTTTGGCAATTCTGGTGAA	75	PIK3CA
GTGATGGCCGAACCAGAAGAAC	CCTGACTAAGAATGGGAAGGAGTCA	82	FGFR1
GCTCGACTTTGCCTTTCCATTTG	AAAAATTCAATCAGCGGTATAATCAGGAG	72	PIK3CA
TTAAACCCAATGCCCAGACCCAAA	CTCCTCGGAGGATGATGATGATG	85	FGFR1
TTCAAAAATGAGTGTTTAAATTGTTTAGCAAAG	GCCAAACCTCTGGCTAACTGTT	79	PIK3CA
TTGATGCTGCCGTACTCATTCT	CTCAATGTATCCCTTTGGCATTTCC	81	FGFR1
ATGTGGGATGTATTTGAAGCACCT	AAAAGAGTCTCAAACACAAACTAGAGTCA	86	PIK3CA
GCTGCGGGTCACTGTACA	AAGTGCCTCCTCTCCCATCT	96	FGFR1
CGAGTGTGTGCATATGTGTATGTTGA	TACTCTTTGAGTGTTCACATTGTCACATAA	75	PIK3CA
GCTTTCTCCAGCCCAAGAATCTAT	CTGACCTCTAAGGTGGTCACTTG	78	CDH1
AAGAGATCGTTAGCAGAAACAAAAGGA	TCTACTCCCACGTTCTAAGAGAGTG	73	PTEN
GTCGAAGCAGGATTGCAAATTCC	TTCCAGGAAATAAACCTCCTCCATTTTT	78	CDH1
TACGCATGCCTGCTTCTACAA	CTGGAGCCCATACGCAACGA	84	CDKN2A
CGGGCAGTTACTTACTCTTGTTGT	CACATCCATGGAATATGTTCTTTTGCA	73	FGFR2
AGTGGATCTATATGAACAGAACCTTCACT	ATCTGATAAGCCCACTGGAAAAGG	86	KIT
AGTTCTTCCTTCTGTTTTTCAGGCT	GGTATCCTGATGTGCACGAACA	91	CTNNB1
TTTTTCTCCTTTTCTGAAACCAGCA	AGAATCATTAACTCTCGCTGAACTGATAG	70	KIT
ACCTCCTAAGGCTAGAACAGATATTTAGG	TGAACAAGACGTTGACTTGGATCTG	85	CTNNB1
ACATTTCTTTTCATTCTAGCCTTCAAAGC	TCCACGTTGAGTACACAGAACTAGA	84	KIT
CTTTCTATTCTTCCTTGCTTTGTGCA	GCTTGATCTGGAGTTAATCGAGAAATATGA	80	CTNNB1
AGATTTACTCCAACTTAGCAAACTGCA	TCAGACATCGTCGTGCACAA	83	KIT
GGGAGTAGTTTCAGAATGTCTACCCA	GTCTGGAAGCTTCCTTTTTAGAAAGC	82	CTNNB1
GGATTCCAGTTAAATGGATGGCAATTG	CTACATGTATAAGGGTGTTTCTGTAACCTC	68	RET
TTCTCCTCAGATGGTGTCTGCTA	CTCCAGACTTAAAGATGGCCAGTAAG	87	CTNNB1
TCACTCTCTGCAGATGGTCTTTTG	CAGTTGTCTGGCCTCTCCAT	94	RET
GTATGTGCTTGTACTGACCATCTGT	CAAGTGAGGTTAGAAAGAATTCCAGCT	87	CTNNB1
GTCTGTGTGGAAAACTGCCAG	GTGTCATTCACAAACAGGATCCC	92	RET
AAGAACAAGATGATGGTCTGCCAA	CGGCTGGTCAGATGACGAAG	80	CTNNB1
ACCGACCAGCAGACCTCTAG	GCTTTTCTCAAAGGGCAGGAGG	97	RET
ACTGTGGATAGTGAGTGTTGAATTAACC	CAAACTGTGTAGATGGGATCTGCAT	84	CTNNB1
CCACTCCATCTGACTCCCTGAT	CATAGAGTTTGTTTTCAATCCATGTGGAAG	73	RET
ATCCCACTAATGTCCAGCGTTT	CGTCATTTAGCAGTTTTGTCAGTTCAG	85	CTNNB1
GATGCAGTATCTGGCCGAGAT	GGCTAGAGTGTGGCATGGTG	98	RET
TGGGTAAGAAAACATGTCAGAATGCT	GGTTGTGGAGAGTTGTAATGGCATA	88	CTNNB1
ACGCTGCGTGTCTTCGAT	TGGACCGAGGTCTCGTTGG	102	RET
GCTAAAATGGCAGTGCGTTTAGC	TGCTTTCTTGGTTGCCATAAGCTAA	81	CTNNB1
CAGAGCAGCTTGGTGGTCAT	CCCTGGAAGTCTGAGTCATTGAC	81	RET
GGCTCTTCTCAGACATGTGATCA	ACAGTAGTTTTTCGTAAGTATAGGTCCTCA	86	CTNNB1
TCCTACCTGGTCTTCTAGGAAGC	GGTTTTCGTGGTTCACATCCC	92	CDKN2A
AGAATGCAGTTCGCCTTCACTA	CTTCATTTTCAATTCTGCAACAAAGGTAAA	76	CTNNB1
CCTTACCCTCTTCTTTGCATTTCTCT	TTTTCTTAGTTGGCACTCTATGTGCT	86	FBXW7
GCGTCTTCCAGAACCTGCAA	AGTACTCCCTCAGGCCCAAA	89	ERBB2
GCATACAACGCACAGTGGAAGT	GAGTATGGTCATCACAAATGAGAGACA	85	FBXW7
CCCTGTTCTCCGATGTGTAAGG	CCTGTATGACACCTGCATTCCA	91	ERBB2
CAACGTGTGTAGACAGGTTTCAG	CATGTTTTGATGGGTCATGTTGCA	81	FBXW7
TGCAGGGAAACCTGGAACTC	CACCTGTAAACAGAGGGCTCA	83	ERBB2
CCCAAACCCTAAGAGTGGCAT	AAAAACCTTGACTAAATCTACCATGTTTTC	88	FBXW7
TAGATCCAATTCCACGTAGGGAAAAATG	TTAGGTTTATTGAAGTCAAAATGTCCAAAAA	77	IDH1
AAAGGTGGTAGCTGTTGAGTTATATATTCAAAT	GTAAAACATATGATGCAAGTGATAGAACCC	73	FBXW7
AAAAAGAAGCTTATGCTACAGTCATACA	CAGTACAGAGCAACTGATTTTGTTGTTC	83	IDH1
TTTTTCCAGTTGCTACTTGCAATGA	GGTAACCGAATAGTTAGTGGTTCTGATG	84	FBXW7
GATGAGCCTATGCTCATACCAGATC	ACAAGCAGATGATATCCCTAACAAAATCAA	69	IDH1
CACAAAACTGTAAGCATGTGATCACA	GCCTTCATTTTTCTCTTCACCAGTATTTT	73	FBXW7
TCTCCAAGTTTATCCATGAACTCAAATGT	ATTTCTAGGACTTTACCACTACCTGCTA	72	IDH1
CGGATGAATAATCCCTTATTTTGCAGC	CAACAACGACGCCGAATTACATC	87	FBXW7
CCTGGAGTAAAACTGCGGTCAA	TGCTTCCATTTACAAACCCTCTTCT	88	APC
GCTGAACATGGTACAAGCCCA	GCCAGATCATCATTCTTTGTACTAGAATCTATT	85	FBXW7
CTGCAGTCTTTATTAGCATTGTTTAAACGT	TTTTAGTGAGATTCTGAAGTTGAGCGTAAT	75	APC
TGAACAAAACGAAAGGTGAGTAAGACT	GGAATGGAACTCAAAGACAATATTCTTGTC	72	FBXW7
AGACATTTAGTAGCCAAAAATAAAGCTTGG	TCAGATTTTAGTTGGGCCACAAGT	82	APC
ACATCCCAAACACGGATTGATGTA	CCCTTTCCTACTAGGATTAAGGTCAGTAAT	85	FBXW7
GATTGTCTTTTTCCTCTTGCCCTTTT	AAAGCCATTCCAGCATATCGTCT	90	APC
CCCTGTCATCCTCACACTTTTCC	CCACTTTTCCAAATTCGCCTTCT	90	RET
ATTAGGTTTTGTTTGTGTTTTCTCCTTAGC	GCTCCCTCAGCTTCAATAGCTT	80	CTNNB1
GCCGTGAAGATGCTGAAAGGTA	AGCCGCTCTAGAACAGCATTG	93	RET
CATTTCCAATCTACTAATGCTAATACTGTTTCG	CCAGAGTCCAGGTAAGACTGTTG	73	CTNNB1
GCCTTATTCTCACCATCCCTCAC	GCAGGGCATGGACGTACAG	97	RET
ACAGCTCCTTCTCTGAGTGGTAA	CTCTTACCAGCTACTTGTTCTTGAGTG	74	CTNNB1
CTACGGCACGTACCGCACA	CTTACTGCGGACACTGAGCTT	86	RET
TGACACCCTGACTCTTCTAGATCC	CCCATCAACTGGATAGTCAGCA	92	CTNNB1
GAGACGGCTGGAGTGTGAG	GTTTCCACCGGTGCCATC	98	RET
GTGCCCACCTTTCTCCCATAG	CGAAGCAGAGGTGGGTGTTAT	94	ERBB2
GGGACCAGGGTTTACACCAG	CTTGAGGTAGACGGTGAGCA	97	RET
GTTTGGAGGACAAGTAATGATCTCCT	CACTTTGATGGCCACTGGAATTTTC	88	ERBB2
CACCCACATCCCTTCGTGAG	CCTTGTCTCTGGGAAGCAGAG	89	RET
CCCTCCCAGGATATCCAGGA	CAGGGCATAGTTGTCCTCAAAGAG	81	ERBB2
GTTTGCGGACATCAGCAAAGAC	AACTCTGAGGGCTAAAACTACTGC	92	RET
ATGGAGACCCGCTGAACAATAC	CTGAATAACCAAGAGAAGGTTTCAATGAC	73	ERBB2
AGTTCAACGTCCTGAAGCAGG	GAGAACAGGGCTGTATGGAGC	97	RET
ACGGTAATGCTGCTCATGGT	TGCTGTCACCTCTTGGTTGTG	98	ERBB2
GGCTATGGCACCTGCAACT	GATGTGCTGTTGAGACCTCTGT	89	RET
CGGTGTGAGAAGTGCAGCAA	GGGTCTGAGGAAGGATAGGACA	86	ERBB2
GAACATCAAAGGGAGTTTTGCCA	CGTGAGTGGTACAGGACTCTCT	93	RET
GTGAAAGCCAGCCACCTGT	CTCGGGATTGGGCATGGA	88	ERBB2
GGCACTAACACTGGGTTTCCAA	CTTGTGAGTCCATTACCTTTCACAAAG	84	RET
CCTCCACAGAATGAGGACTTGG	CTGGACAGAAGAAGCCCTGCT	95	ERBB2
CAATTCTGTGCTGTCTGATGTATGC	GAAGGCAATTTACTCTTGAACTGTAACAC	78	FBXW7
ATTGCTCTTCAAATAACAAAGCATTATGGT	CATTGCATGTCTATGCTCTTCATCAAAT	79	APC
GGAGTATATCGTCTACACAATTGGACA	CTCAAACACAAAGCTGGTGTGT	90	FBXW7
CAATTGGAACTTACTTAGCTACTGCTTG	ACAGCATCTTCATTTTGAGCTACAATAGTA	79	PDGFRA
ACCCGTTTTCAAGTCCCATAGTT	ACCAGTAATTAAATTCTTTTGGTTTTTGTCT	85	FBXW7
TCCTTACTCATGGTCGGATCACA	CTAAAAATCCTTTGCAGGACTGTCAAG	83	KIT
TTTCCTTCTCAGGCAGGCATAC	GGGCACAGAATCACTGAAGG	96	FBXW7
TTGACAGAACGGGAAGCCCTCAT	AGACAATAAAAGGCAGCTTGGACA	85	KIT
CTGCTTGGCAGTCTCTGACAATAT	GCCTTTACTGTGGAGTTTTGTTGC	84	FBXW7
CATCCATCCAGGAAAATCAGACTTAATAGT	CATTCATTCTGCTTATTCTCATTCGTTTCA	71	KIT
CAATACTACTGGAGTTCGTGACACT	TGGTGAACAAGATGAGGAGGATGA	84	FBXW7
GTATCTTTCTCCTGTAAGATCTCCAAAGAA	GAAAGAGAGGTAGATTTCAATGGCTTCT	70	RB1
CCAGCATGTTCTTCATCTTCCTCTT	CCTAGACCTGGAGGCCAAAATG	80	FBXW7
GTTCCCAGGGAGGTTATATTCAAAAGAAA	CCTGATTTCTATGTTTTTCTGTAGCTCAGT	65	RB1
ACTTCACCATTCCTTGCAGTGT	CTCTCTGAGAGGTAACCCTTCCT	80	FBXW7
CCCTTCATTGCTTAACACATTTTCCTATT	ATGGCTTACGTTAAAATAGGAAATCAGATTT	79	RB1
AAATTTGAGGCATCTTTTCACTAAAAGAGG	AGATATTTAGCATTAGCATCATTGCCCAA	77	FBXW7
CAGTTCTTCATCCTTTTTCCAGCTTC	GAATCCAGAGGTGTACACAGTGT	89	RB1
CAGTTTGATGTGGTAGAGGCTCTT	CATGTAGAGAGTATTCGTCAACCAAGAG	73	FBXW7
ATGATTATTTTCATTTGGTAGGCTTGAGTTT	CTTTCTCCCAAGTTAACCAAGCTCT	68	RB1
CGATGTCGGTCTCGCAGT	GCAGACCTGTGAGGTCGAC	99	NOTCH1
CATAATGTTTTTCTTTTCAGGACATGTGAACT	CCCTAACTATCAAGATGTTTGAGATTATTCCAT	74	RB1
CAGTCGGCGTCAACCTCA	TTCGAGGAGCCCGTGGTTC	102	NOTCH1
GAAGATGATCTGGTGATTTCATTTCAGTTAAT	CAACTGCTGAATGAGAAAGTAAAAGGG	80	RB1
CCTTCATCGTCTCGGTGCT	AGGAGTAGCTGACCGGGAA	93	RET
CCAGAATGGCTCAGTGACCT	GATAGCACACCCTACTGCATCTC	84	ERBB2
GTGCAGGGATCACCAGGAAC	CCTGATTAAACCCTGCTTACGGAG	92	RET
GGAACGTGCTGGTCAAGAGT	TGCTCCTTGGTCCTTCACCTAA	84	ERBB2
GGACGTCTCCTGGAGATGGAT	CATGGACAAGCCCAGTAACTG	95	FGFR1
CCCACAGAGATCTTGAAAGGAGG	GCGGTTGGTGTCTATCAGTGT	87	ERBB2
AGTTCCTCCACAGGCACAC	GGAGGCGGAGAAGCTCTAAC	85	FGFR1
AGAGCAGCTCCAAGTGTTTGAG	GCAGGCAGAGGGTGAGATTAAAG	79	ERBB2
CTGTGATGGGCGAGAGGAA	GCATCGTGGCCTTGACCTC	100	FGFR1
CCCTATGGCTGCCTCTTAGAC	CTCCGGAGAGACCTGCAAAGAG	81	ERBB2
CGTATTTTGGCTTTGAAATGGAACTGA	CTCTCCACCCAAACCCTTGTAG	75	FGFR1
CCCAAAGGTGACCTCTGTTTT	TCCAGCCCTAGTGTCAGGT	97	ERBB2
TACAGCTGACGGTGGAGTCT	GGGAGGATTCCGTCTTCTCTC	98	FGFR1
CTGGCTCCGATGTATTTGATGG	GTAGCCATCAGTCTCAGAGGG	96	ERBB2
GTTGTCTTTTTATAGTAGTCGATGTGGTGA	CCTCCTTCCTCAGTGCATACAC	79	FGFR1
GTGCCCACTATAAGGACCCTC	CGAGTGGGTGCAGTTGATGG	98	ERBB2
GTTGACCACATCACCTGCAAC	CCACACTCTGCACCGCTAG	98	FGFR1
TGGCCAGGTCTGAGAAGGT	TAGAGGTGGCGGAGCATGTCC	96	ERBB2
CCACATCCCAGTTCTGCAGTTA	TACCTAGACCCTCCTAACTTTTGGG	90	FGFR1
ACTGCAGCCAGTTCCTTCG	CCTGAGAGAAGGGACAGTGGT	99	ERBB2
CCTTCCACCACTAGAATAGCAAGC	TGGGACTCCCATGCTAGCA	96	FGFR1
TGAACCAGCCAGATGTTCGG	GGCAAAAACGTCTTTGACGACC	97	ERBB2
CCCAGCAGGTTGATGATATTCTTATG	CCAAGTAAATGAGTCTCAACGTGTTCTT	72	FGFR1
CCTCCTCAGTGTGCTATGGTCT	ATCAAAGCTCTCCGGCAGAAAT	89	ERBB2
GCTTGAAGACCACGTTGGTGT	TGCGGAGCATGTACCCGAG	99	NOTCH1
TGCAGTAAACATCTCCCAGGAGA	TATATAACGAAAAGACTTCTTGCAGTGTAAACA	71	RB1
CAGGTGCACACGTAGCCA	AGGTACAAGTGCGACTGTGAC	91	NOTCH1
TGATCATGTTGTAACTTCATCTTTTTCAGGT	AATTTCCTTTCAGATTACCTCTGGAAGTC	64	RB1
GGGTAGGTTGGAGACCAGCT	CTCACACGCCGACGTCAA	91	NOTCH1
GAAAAATCTAATGTAATGGGTCCACCAAA	GTAAGGGTGAACTAGGAAACTTGTAAGG	77	RB1
GCAGTCAAAGCCGTCGAAGA	TGCTCCCTCAACTTCAATGACC	86	NOTCH1
CGGATTCCTGGAGGGAACATCTATAT	CCTCTCATTCTTTACTACTTCCCTAAAGAG	82	RB1
CGCGTGGTTGTTGCACTG	CACATCCTGGACTACAGCTTCG	97	NOTCH1
AAAATGCTACTTAACAGCATTATAATTAGAGC	GTATTTAGCCGGAGATAGGCTAGC	83	RB1
TACGAGCGTCATTCTCACACG	TTAGAGGAGAGCGGTGGCACT	97	NOTCH1
CTTCTGTCTGAGCACCCAGAATT	GGAGAGAAGGTGAAGTGCTTGATTTT	83	RB1
GGTGTAAGTGTTGGGTCCGT	GCTGTTGCACATGACTCCCTC	98	NOTCH1
AAAACGAAATAACACAAATTTTTAAGGTTACTG	ACATAGCATTATCAACTTTGGTACTGGT	66	RB1
CCACTGCCTACCTGGAAGAC	CCGCTACTCACGCTCTGA	99	NOTCH1
CACGGATAGCAAAACAACTAGAAAATGA	GGGAGAACTTACATCTAAATCTACTTTAACTGT	78	RB1
TCGCAGTTGGGTCCTGAAG	GCGACAACGCCTACCTCTG	98	NOTCH1
GTTGCTAACTATGAAACACTGGCAT	CTTCAGCACTTCTTTTGAGCACA	85	RB1
TGGAGCACTCGTTGATGTTGG	CTGCGAGGTGGACATCGAT	99	NOTCH1
AAGCAACCCTCCTAAACCACTG	GCAGTGCTGAGACTCTGGATTC	95	RB1
CGTCGCAGGGATTGGACA	CCCAAGTGCTTTAACAACGGC	87	NOTCH1
GACCGAGAAGGACCAACTGATC	ATTTGCAGTTTGAATGGTCAACATAACAT	73	RB1
CCAGCCTCGACTCGGTTTC	TCAACGAGTGCGTCTCGAA	88	NOTCH1
GGTTGAAAATCTTTCTAAACGATACGAAGAAAT	AAATCAATCAAATATACCATGTGCAATACCTG	74	RB1
GCAGGACATCGAGAGGAGAAGTTA	CTTCACTTAAGAAATGTCTCCTTTGAGGA	86	FGFR1
ATTATTACAAAATTAACAAGGAAGGCAGAACG	GGAGGAGAAGAAGGTTTCTGGAG	84	FGFR2
CCATCCACTTCACAGGCAGTC	CATCTGAGAAGCAAGGAGTGGG	94	FGFR1
CCATATATACAAGTGGAGACAACAAGCT	TATCCACACATAAACGGCAGTGTT	86	FGFR2
TCTGTTACCTGTCTGCGCAG	CTTCCTCATCTCCTGCATGGTG	92	FGFR1
AGAATCATCTCCTGAAGAACAAGAACTTC	ACCCAAGATGAAATAAAACGTCTCTCTTC	68	FGFR2
AGCATCACTTACACTTCAACATCTTCA	CGAAAGACTGGTCTTAGGCAAAC	89	FGFR1
TTAAATGACTTACCTTCTGGCTCTAATGTG	GATTGGTACCGTAACCATGGTCA	84	FGFR2
GCTCAGTGCATCCACAACG	CGAGGCATGGAGTATCTGGC	99	FGFR1
TGAAAACAATGGTGACTACATGGACA	TCTTATATGAGGCTGGACGATCATAGAG	79	PDGFRA
CAGGTACTCCCGCAGGTTG	GTTTCTTTGAGGTGAAGCCAAACC	82	FGFR1
CCTGTGCCCACTCTTGAGTTC	ATATTGTCCAGGCAGCAGATTCTC	86	PDGFRA
CTGAAACTGGCAGAGAGGGCT	CGGCCTCTATGCTTGCGTA	99	FGFR1
AATGGAAGCTCTTAAAACCGTGTATAAGT	CCAAGCCATTGCACGTTTTGAG	88	PDGFRA
CTCCAATTCTGTGGTCAGGTTTG	AAAGATGGAAAAGAAATTGCATGCAGT	86	FGFR1
TCATGCCAAGTGTTTCAGCAATG	ATCCGGTACCCACTCTTGATCT	92	PDGFRA
AGCGTGAGGAATGATCCCATTC	CTGCCTTATGTCCAGATCTTGAAGG	92	FGFR1
TGGTAGCTCAGCTGGACTGATA	CAGCAAGTTTACAATGTTCAAATGTGG	85	PDGFRA
ACACAAAATGTTTCGTTTTGTTTTTAACTT	AGGTGGTGAGAGAGACCTCAAA	81	CDH1
TTTGGGTGTTAATGATTCTGCCT	ACGTTTTAGCATCTTCACTGCAAC	90	PDGFRA
CCCATCTTTGTGCCTCCTGAAA	CAGTTGAAAAATCCTCACACTTACGTTATT	87	CDH1
TTTTGAATGCCATGTAGATGAGTTGTG	GTGATCATCGACCAAGTCCAGA	90	PDGFRA
CTTTCCTTTTAGGCCTCCGTTTCT	GGAAATGGGCCTTTTTCATTTTCTGG	89	CDH1
GGGCCACAGTCTAGGTCTAGTT	CCTCTCTCTTGATGAAGGTGGAACT	85	PDGFRA
GAGCACTCATCCACGTCCT	ACCTCAACGACGCATGCA	101	NOTCH1
AAAAATACCTAGCTCAAGGGTTAATATTTCA	TAAGCACATTCAGAATCCATGGGAAA	69	RB1
GCAGTTGTTTCCTGGACAATCG	TGTCCAGAGCAGTGTGTCG	97	NOTCH1
TTTTTGATGCATAAAGCACAAATTGTAAATT	TGGAGTGTGTGGAGGAATTACATTC	83	RB1
ATGTCCTCCTCACAGAAAGTGC	CTCACACTCACCCTTCCGT	84	NOTCH1
TCATAATTGTGATTTTCTAAAATAGCAGGCTCT	ATTGTTTTTAACTTACTGATTTAAGCATGGAT	65	RB1
GCACACCTCTCTGTGCAGT	TCAACGAGTGTGCCAGTGAC	99	NOTCH1
TTACATAGACCCAACACAACTTCCTTATG	AGTCACTGTTATGTGTACCCAAAAAGG	68	KIT
GGACAGCCACTCGCATTGA	ACTGGCCCACCTCGTCTCTC	95	NOTCH1
ACTCTTGCTCCTTCCATCCTTG	GTTCATCCTGCTGGAGCTCAT	96	ALK
GCACCAGGTTGTACTCGTCC	CTACGAGACCGCCAAGGTG	100	NOTCH1
ATGAAGATGATGACGATGATGATGAAGAG	AAAACCCTCATGCATATAACTATGTCAAATTC	65	NPM1
GTTTGCTGGCTGCAGGTTC	CCCTGTCCCAGATGATGAGC	91	NOTCH1
ATGGTGCCCTTCCCGGTGA	CACTGGGTAGACCACAGCAC	99	RET
CACGTCTGACAGGTAGCCA	CTGTGGAAGCAAGGAGGCCAA	98	NOTCH1
TTCGATGATCTTCATCTGCTGGTC	CGTTACTCTGAATCTTATCTTCCAATGACTTC	68	BRAF
GCTGGCCTCAGACACTTTGAAG	GCTGCACTTCATGTACGTGG	96	NOTCH1
TCCTTTTGTTGCTACTCTCCTGAAC	GGCTGGTTTCCAAACAGAGGAT	91	BRAF
AGCAGAGCTCCCAGGGTTTA	CCTGCCTGTCTGAGGTCAAT	89	NOTCH1
TATTTACCTGGTCCCTGTTGTTGATG	GCACCAGAAGTCATCAGAATGC	90	BRAF
CTCATCGATGTTGATGTTACACATGC	ATGTGGCCAGAAGGGTGATC	92	NOTCH1
GTCAGGATGTTTTCAAACTTCGCA	GAGTCCTTTAGCCCTACTCAGGTTA	88	BRAF
GGGTGGTACTCACACGCA	TGAGACTGACCTCTCTTCTCCTG	84	NOTCH1
AATTCACACAAGCTCACCTGAGT	TGACACTTGGAGTAACAATTGCCT	83	BRAF
TGTCCCTTCTTCTTTAGAATCTGAAAGC	GGAGTTCAGGGAGCTCAGACTAG	76	CDH1
GAAGACATCGACATGATGGATGACA	CAATAAAGTGGTTTTCTGAACGGGAT	88	PDGFRA
GCTCGGCCTGAAGTGACT	TTTCCACGTGGATTACTTACTTCATCAAT	80	CDH1
CCCTTTTGCTGTAGAAAGGCAAA	ACATTCGTAATCTCCACTGTCTTTCAC	74	PDGFRA
GAGAACGAGGCTAACGTCGTAA	GTGGTGACGACAAATTGTCCAC	80	CDH1
GTTCTGAGTGTCTCTATTCATTTTTGAGGT	ATGCGTGCCACAGCAGGAT	84	PDGFRA
TTGGCAGAGAAGTACCAAGGAGA	GCCAGTGATGCTGTAGAAAACC	94	CDH1
TGCATACATTGGTGTCACCTACAAA	TCAGGGACAGGGTCAATGTCA	85	PDGFRA
GGTGTCTTTATTATTGAAAGAGAAACAGGA	AAAAATCCTGGGTGGATGTTACC	82	CDH1
CGCTGGAGGGTCATTGAATCAA	CCATGGAACTTACCAAGCACTAGTC	80	PDGFRA
TCTGTCCAATTTCCTAATCTCTGTGATTTC	GCCTTTTGACTGTAATCACACCATCT	82	CDH1
TGCAACCTGATGATTTCCTGCT	TGATAGGTGAAGCTCAACAAATCCAATAAA	86	PDGFRA
CCCACAGATCCATTTCTTGGTCTAC	GCGAACTTCTCAGAAAAATGCCAA	88	CDH1
TGCTCGGGATCCATATGTGGTA	ACCTCTACAACAAAATGTTTGACTTCATG	88	PDGFRA
GAAGAAGCGCTTAAGCCGTTTT	CCGGATTAATCTCCAGCCAGTT	80	CDH1
CCTACCCACCTCCCAGGATATC	GCATACTTGGGCAGAGAGTTTCTTTAC	77	PDGFRA
CGTGAAGAACAGCACGTACACA	ACTCTTCCCTCCAAAAGAAGGGA	87	CDH1
ATGGCTTTTCTGTTCTTCATTTTCATACC	CAGGAAGCTATCCCTATTCTTATGCAAATA	77	PDGFRA
CCCAAAGTGCAGCTTGTCTAAAC	GATCTTGGCTGAGGATGGTGTAAG	92	CDH1
GAGAAGCCAAAGAAAGAGCTGGATA	GGTCTTTCCATTTGTGATGCCTGTA	74	PDGFRA
GTTCACCATTAACAGGAACACAGGA	GATTTTGCTTTGTCCACGGGATT	87	CDH1
TGATCCTGAGTCATTTCTTCCTTTTCC	AGTTCGAATCATGCATGATGTCTCT	86	PDGFRA
TTCGGTGAGCAGGAGGGAACC	GCACCGTGAACGTGTAGCT	97	CDH1
GCTGTTGGTGATTGTGATCATCTC	CACTGAACTAGGTTGCTATGCTTGT	75	PDGFRA
GTCCCAACTCCTTGCCATCTTA	TGTTGGCCAAAATAGTCCAGGAA	89	PDGFRA
ACAGTGACTGCAGTTTAGATAATGCTTAAT	ACCACCTGGAGACATAGTACTGAG	81	ALK
AATGTCTCAAACATCATCACGGAGAT	GCTCCAAGGAGATTCTTAGCCA	76	PDGFRA
GCCTCTCTGAGTGTGGAGAGAA	AGACTGACACCAGGTATTTTGATGAG	77	AKT1
CTGCTGTGGATCATCAGTGAGT	CATAAGACCAGACATCACTCAGTGT	92	PDGFRA
ATCTGGCTCTCATCTTCTCCCT	GTGTGCTCTCCAGGAACATCC	96	ALK
GACCCAGATGTAGCCTTTGTACC	ACTGTTGTGTAAGGTTACAGGAGTCT	76	PDGFRA
GGGTGGAACGTGTCTGTCTTG	AGCTCGGTTTCTCAATGTCTGAAT	79	ALK
GGCCCTATATCTGTGAGGCCA	CACCTTATGATTTTGCCTGTTACTCTTATTTAA	78	PDGFRA
ACTAAGATGCCCTCAGGCATG	GGAGAATAACTCCTCGGTTCTAGGG	93	ALK
CGCTGAAGCTCCATTTTGCATT	CTGCAGCTTCTTTCAAGAACTCTTC	89	ABL1
CCTCACATGGAGAGCTCTTGATC	CGTGCTTGTGATTCTTTTCCTCTCT	83	ALK
GGCCAGTAGCATCTGACTTTGAG	GGCCACAAAATCATACAGTGCAAC	83	ABL1
GCATCCACTTAACTGGCAGCAT	TGCCACTTTCTCAACTTTCCCA	92	ALK
GCTGACCGTTCTGGAAGATCTT	CCTGCTCCTTTGATAAAATGCAGG	92	ABL1
GTCAGAGTGAACTCACTGGTGA	CTCACACACATTCCTCTTGATGTG	93	ALK
GGAAGAAGGAATCATCGAGGCAT	AAAGTTCCTTGAAGGCCTAAGATGAAT	75	ABL1
TGCTCTGGGCACTTACACTG	GCGGGAAGAACACCATGATG	94	ALK
CCTCTAGAGTTGTCTGGAGTTGTC	AGAAGGCGCTCATCTTCATTCAG	92	ABL1
GATCAGGGCTTCCATGAGGAAA	CTCTGTAGGCTGCAGTTCTCAG	81	ALK
GAAGAAGTCCAGCACGCTGA	ACCTCCACTCCGTGTCCTT	97	ABL1
AGAAGTGTTCCTAAAAGAGTCATACACAG	GGGAAATCTTTTCTCTTGGATATATGCCA	81	ALK
TCTGCCTCGGAAGAGGGCA	CGGGCTGGACTCCATGATG	97	ABL1
CTGGTATAAAATCAATTTTGGACATGGAGA	CAGCCCTCTGGAAGGTACATTG	75	ALK
GACAGCGACAAGATCATCTACTCA	GCGCTCAGACCAGGTTGTA	86	GNA11
TCTGTTGCCTTTGAACCTTGACA	CCACCGACACCTACAGGTG	92	ALK
CACGTTCATCAAGCAGATGCG	GGATCTTGAGCGTCTCCATGG	97	GNA11
CAAGGCATAAAAGCTGGGAAATAGG	CCTACCTGCCTACGCAACA	95	GNAQ
AGCTTTCTGGTGGATGTGTGG	CTTGATGGCACTGACGTACTGA	96	GNA11
CCCAGTAAGGTCCACGGTA	CATGAATGGAATGGAACCAAACTGA	90	HNF1A
GGGAAAGTTCTGCAACCCAAGA	GGAAAGCATCGAAGTCTCATGCA	90	KDR
CCTATTCAGAGCGTGCTTCCTT	CCCAAAGCATCTCAGAGAAAAGGA	85	PDGFRA
TCGTCTGATTCTCCAGGTTTCCT	AACTGTTTAAAAGTTTGCTGATACCAGAAC	73	KDR
TCTCCAGGCTTAACACAGCG	CCTTAGGAGGACAAAGGCCTG	97	JAK3
GCTCAGCTGTAAGAAATGCAAGATG	CATGTACGGTCTATGCCATTCCT	91	KDR
TTCTCTGGAGCAGCGTTCTTTT	CCCAGCAGTTACCGAAAAGATAG	91	NPM1
TACATGTCAGCGTTTGAGTGGT	TCAAAGCTGACTGACAATTCAAAAGTTG	74	KDR
GGGTTGGTAGGATTCTATTACTTACCT	CTTGGTTTGATGCTGTGCCAA	87	MLH1
GCTCCAAAACTTTAATGCTTAGGCT	TGAAGATATCCCGTTAGAAGAACCAGA	86	KDR
GGTTTCAGCATCGGCGAAATC	TTGAGAGAGCGCGAGGCTTT	91	GNAS
TGGTAAAGAGACGTGGGAAATGAATT	ACTCACAATTCCAAAAGTGATCGGA	88	KDR
GTGGGCACAGCAGGTTACC	CGGCAAATGCTGGCAGAC	93	NOTCH1
ACTCAGTCACCTCCACCCTTT	CCTCACAGTCTGGCACTTCATATTAATAC	74	KDR
TTGTATAAAAACATGTGTTTTAAAAAGGCTCC	GCATTCCGGAGGCCTTCAA	87	NOTCH1
GTCTCCCTACCTAGGACTGTGA	ATTTTGATCATGGAGCTTAAGAATGCATC	76	KDR
ATCGTTCGGAAGCGCACG	TAACATACACAACTGCTAATGGCCC	96	EGFR
GAACATGGTGGCATTCAATTTCCA	GCACTGCAGACAGATCTACGTT	93	KDR
TTCAGCCCAGCCTTCGACAA	CACACTGGCACGTCCAGA	92	ERBB2
GGAAATTGTCCAGGCTCAAACCT	ACTCGTGGCTTTTGTCTTTGC	95	ABL1
AGCAGAGCTGAGGTTTTAGAAAGTG	CCGCCTTCTCTTCCAGATCT	94	ALK
CTAGGAACTCCGAGCAGATGG	TTGTTGATGGCCTCTCGGAAG	93	ABL1
TCTCGGGCATCAGGCGGAT	CGAGGAGGCGATCTTGGA	102	ALK
GAATAATCTCCGGGAGCTTCAGATC	ACTGCTGCTACCTCTGCACTA	81	ABL1
CCAGTGGACTGATGAAGGAAACC	GTGTGTGTGTGTTAAGATTTTGGCA	89	ALK
ACTTGTTCAGCGCCTTGATCA	CCCGTTGCTGATGTCTCG	100	ABL1
ATGTGAGCCCTTGAGATCTGC	ACGTGGCTCGGGACATTG	100	ALK
TGGAAAGGGCAGTGCCTTAG	GCTTGTGCCTCCTCACTCT	91	ABL1
AGATGCATAGAGCCTACCTGTCA	GTGCTAGTGGAGAACAAAACCG	90	ALK
AGATCTTGCTGCCCGAAACT	CGGGTGCAGTCCATTTGATG	99	ABL1
ACTAGCACCAAGGACACGTTTC	ACTTCAGTGGAGAATTCCAGAAAGG	86	ALK
GCGGAGCCACGTGTTGAA	GGTTGCACTCCCTCAGGTA	89	ABL1
TAGTACCTTGGTGGTCCTGGAA	GGGTTTTTACTGCAACTTTGAAGATGG	75	ALK
GCTGTACATGGCCACTCAGATC	GGGCTTTTTGTAAAAGGCTGC	96	ABL1
GTGGCACAGCCTGAGACACT	TCCTCTCTGTGGTGACCTCTG	98	ALK
AGCTGATATGTCTGATTTGGTTCCTTT	TGACTGGCGTGATGTAGTTGC	91	ABL1
GAGGGTGATGTTTTTCCGCG	CTGCAGAGCCCTGAGTACAAG	96	ALK
CGCAATGCCGCTGAGTATCT	GCAGTGTTGATCCTGTAATGGTACAC	90	ABL1
AGCCTCTCCCTTACCTCTGG	ATGACCTCAGGAACCAGAGCT	83	ALK
GCTGAAGGCTGTTCCCTGTTT	GGATAATGGAGCGTGGTGATGA	82	ABL1
CAAAGTTGGGCCTGTCTTCAG	GGGCTGGAAGAAAATATATTTTTCATCATT	74	ALK
CAAGCCCACTGTCTATGGTGT	CGTCAGGCTGTATTTCTTCCACA	94	ABL1
CTGGTTTGTGAAGGAGCCATTG	TCATTACGAGGATACCATTCTGAAAAGC	89	ALK
CTGCATGTCAGGTTGCAAAGTA	TTTGGTACTTTGTAGTAGTCTGAAAGCAG	76	KDR
GACATCGAGGATGACATCATCTACA	TTGTTGCAGACAGGCAGGCAC	84	STK11
CCATAGGGAAAATTCTGCACTTACAC	GAGCTGAAAACTTTGGAAGACAGAAC	87	KDR
TGGTGGATGTGTTATACAACGAAGAG	CTCCTTCAAGGAGACGGGAAGAG	90	STK11
CTGCTGAGCATTAGCTTGCAAG	GGCATTTAATGAAATCAGTGTTTTGCTTC	88	KDR
TATCAAAGCAGAAGGCAACTTGACAA	GCCATATGCACATGAATGAATTTCTTCAAT	79	RB1
AATTATCTCACTTGTCAAGGCACAGAA	GTGACCAAGGATTGTACACCTGT	77	KDR
GTGCACCAACAAACACGGCTTAA	CCATATGTCATCCAAAATTAAGAGCAGGAT	71	KIT
ATGGCTCTGCTTCTCCTTTGAAA	CCCTTGAGTCCAATCACACAATTAAAG	74	KDR
AACCACACTCAGACAGAAGAGAATG	TTAGTACATTTAACAGGAGAGACAGGAAGA	70	PDGFRA
AGGAAGCACTAGCCAGTACCTT	AGCAATCCCTGTGGATCTGAAAC	86	KDR
GACCGAGGGAATCATCATGAAAGAT	CATTTCGAATGAAATTTCGAAGATCTCCA	85	MET
AAGGGTATTCCCAGTTGAAGTCAATC	GGTATAGGATTTATGATGTGGTTCTGAGT	76	KDR
ATGACCACTTGCCCAAAGCAAC	ATTTAGTTCTGGAATTTCCCTCACTACAC	73	FGFR2
CTTCTTCACTCTATGTTGTTATCTCCAAGA	GAAGCAAAAATTAATGATGAAAGTTACCAGTCT	76	KDR
TTAAGCACAACAGCAACAGCTGT	TGAACAACAAAAGACCTTTCTTTGGAAAC	74	CDH1
TTCACAGAAGACCATGCCAGCAT	TTTATTACCCAGAGATACCCAGAAAAGAGA	72	KDR
GAAAAAGCCAGAGAAAAGAGAGTTACTC	TAGTTTTTGCATTTTCCTCTACATTTGCAG	72	FGFR2
TGCTCTCACACGAAATGATGCT	GAAGTGGCATGGAATCTCTGGT	94	KDR
TGTGTGTAAAACACTACGCATGTCT	CTCCCAGAGACCAACGTTCAAG	92	FGFR2
ACCTTCTATTATGAAAAATGCCTCCACTT	AGGCATTGTATTGAAGGATGGGAA	82	KDR
GTTCACATGCCACAAAAGGAACT	GTGGGAATTGACAAAGACAAGCCCAA	90	FGFR2
GGCCCTCATTCTAGTTCCTTCTT	GGCTCAGGGTTTTCTATAAGAGAAAATCAA	86	KDR
AGTCCAGAGAATGTTATTTGCTAATTTAAGGT	GTCTTCAAAGGCACCAGAAAACCC	78	JAK2
TGATTCTTAGAAGTGGAAAAGGAGCTG	GCACGTCAGTGGTGTCTCTG	91	ABL1
TCCCACAAGGGAAGTGACGTA	CTGGAGGGAAGCTGTACTGTC	96	ALK
TGTAGTGTAGTGAAATGCTACACATCTT	CATACACCTGGGACAGGTCAATT	85	ABL1
CGTGTGGCTCCTTCTTTGCTA	TCCAACCCTCCTTCGGAGTT	97	ALK
TGGGCTGCAAAAGCTCTAACTT	TTCTCTGGTGAGTTCTCCTTCTCT	78	SMARCB1
CTCTAGGGACTCGAACAGAGATCT	CCTCCTCTCCTGGTCTCTCAAC	92	ALK
CTGCCAAAAATCAGAGCTTGGA	GAATAAAGGAGGTAGGCTGTACTTTTCC	78	MLH1
CCTCTTCCACAAGTGGACCAT	TCATCTCTAAGGTATCTTCTAGATCCAACATTT	78	ALK
GATTGAAGAGCCCACAGGTGAT	CCTCCTTGCTAGGGTTCTTCTG	83	HNF1A
AGAGTGAGCCACTTCTTACCTTCA	CTGTCTCCTCTTGTCTTCTCCTTTG	90	ALK
CTCCCAGGTCATCTTCTGCAAT	CGTACCTCGGTAGCTGTGGAT	89	VHL
CACACACCATACCTTAAATACGTAGGT	AAGTCTGCATTGGAGAGAACAATGT	72	ALK
GAGCTCAAAAAGCTTCTCATGGTC	AGGTGCTGGAGGACAATGACTA	78	AKT1
CTCCACGCTCAGGTTGGAG	GTGACTGCCTCTCCTCTTGTG	84	ALK
TTGGCCAGGGACACCTCCA	GTGGACAACCGCCATCCAGAC	85	AKT1
AGGCAGTCTTTACTCACCTGTAGA	AATGCATTTCCTTTCTTCCCAGAGA	82	ALK
CTGTTTGATTTGCCAGTTTAGATGCA	ACAAACATCCTGCTACTTTGAGGTTTTA	85	MLH1
CATGGGCCAAATCTCAGGCTAT	ATGGACCCTGAAAGCCACAAGGT	90	ALK
AATGTTTGAGTTTTGAGTATTTTCAAAAGCTTC	AGTAGTTTGCATTGGATATGTAACCATTCAT	64	MLH1
ACAGAGTCCTTATTATGAGATAGTGACAGT	CTCCTGATTATTTTACATGGAATCTCACCT	79	ALK
TCATGACTTTGTGTGAATGTACACCT	ATAGGCTGCATACACTGTTTCTATGG	87	MLH1
GACACATCTAACACAATAGGCTACCA	GAGTGGCCCTGGAATACATCTC	87	ALK
TTCCTGCACGAGGAGAGCAT	CCAGAGAAGTAGCTGGATGAGAAG	81	MLH1
TATATCCTCCGCCTCCTCCAC	GCCGGAAAATCTTTGCAGGA	97	ALK
CCTGCAAGTAATTTGAAGAGTTGTATTAGC	TCTAACTCAGTGGCAACTACATTCATTTAT	79	KDR
ATCGCAAAGCACCCATTCCACG	TGTTAATAACTTATGATGCTTTAGATACCCTGC	84	FLT3
ATTTTATAACATGGCCAGAGCAGGAT	CCACTCATGGTGATTGTGGAATTCT	76	KDR
CAGGACTCCACCATGGGAAAC	CTCAGCCAGCAGCGTTGAT	91	CSF1R
TGACAAGAAGTAGCCAGAAGAACATG	AAGTTTCCAACTGTTGATACTCATTCAATT	69	KDR
CTGTCAGTCCAGATCCATCAGG	GACCCACCTTCCAGCAGATC	96	CSF1R
GACTTTGTTGACCGCTTCACATT	CTGAGTGCTTGTGCACAAACAG	90	KDR
CCTCACTCACACTTCAGCATCT	TGTGCGTGGCAGGTAAGAC	85	CSF1R
TTTTGACTGCTACTGTCCTGCAA	CAAGTCTGTTTTCTTGTTGCTGTTGT	84	KDR
AAAATATTTCCCACAGCAAAACACCAA	GGGTTCTGAATCCTTGTCTTCTACC	85	KDR
CATTTGCTGGCATCATAAGGCA	TGTTTATGACTGGAAGGATTGATGCTT	89	KDR
TTTTCAAATTTTAAAACTTCAAACTCACTTTGT	AGTGACAAACCCATACCCTTGTG	83	KDR
GGGATGCAACAGCCTTAGACAA	CCAAATTCCATTATGACAACACAGCA	90	KDR
CCTCCTCCATACAGGAAACAGGT	AGCCATAACAACAGTCTTCTGTGTTTA	88	KDR
AGTGGAGATGGGCGTCACTA	AGCAGCTCGTACTGACGAAG	87	GNAS
CAAGATCTGCTCGCTGAGAAAGT	ATGAACAGCCAGCAAGAGTGGAAG	77	GNAS
CCTCCTAAACATTTCACAGAAGATGGAA	ATACAGAGAAAGAAGAACACATCCCACAGT	71	MLH1
GCAAAGCCTCTTGTTCGTTCCT	CTCCTGTAATTCTCAGGCTTGACTAG	90	VHL
AAATTGTGCTCCAGTTGAAAGGTG	TTGTAAATGAAAGTAATATTTGCTGTGTTGCA	71	ERBB4
GTCAGGTCGCTCTACGAAGATC	CTGAGATGAAACAGTGTAAGTTTCAACAG	85	VHL
GTGCTACTGTCCTCTTGGACATG	CCAACTAGCACAATTCCAGAAGCT	77	ERBB4
CGGTGTGGCTCTTTAACAACCT	GCTGTCCGTCAACATTGAGAGATG	87	VHL
GGAAATTGGAGCAGGTGTGTCT	GAATACCTCTCTGAGTTCTCCCTGAA	80	ERBB4
GGGAGAGTGGTACTCCCTG	CTGGAGGAGGAGAGCTCTAGTG	84	CSF1R
TGTGATCTTAATGTGCCCGTCC	TGGTGTACCGGGACCTCAA	98	AKT1
AAGGTGCTCAAAAATTTCTTCATCTCAC	TAATGTTATATGCTGTGCTTTGGAAGTTCA	66	KDR
GGAGTGAGGATGGCTACAGG	CGCACCTTCCATGTGGAGAC	99	AKT1
GACATGAGAGCTCGATGCTCA	GGAGGGTAAGTTGTATAGTGGCAT	90	KDR
CGGTCCTCGGAGAACACA	GAGACCCGGTCTGAGAAACC	92	AKT1
CAACATCACCACGGGTCTGTA	CACCTTTCAGCAGGTCAGAGA	85	STK11
GCGCCACAGAGAAGTTGTTG	GAGTACATCAAGACCTGGCGG	85	AKT1
TCGCTGACTGTTGCTTCCATT	TTCTGCCCATCGATCTCCATG	84	SMARCB1
CAGTGTAGTCTGGGAGGTGC	CTTTCAGGGCTGCTCAAGAAG	97	AKT1
GTGGTGCTGCGACCCTTATAAT	CCTCTCTTCCACAGTGGCTAGT	87	SMARCB1
TACTCCATGACAAAGCAGAGGC	GTATCAAGCAGCGTGGTGTC	96	AKT1
TGTCTGACTCCACGAGAACTTGA	TGTTAACCTTGCAGAATGGTCGAT	91	GNAQ
TGCGTGAGTGTGGATATGTGG	GAGGACGCCAAGGAGATCATG	90	AKT1
GTGGATGCTTCCTTTTAAACAGGAG	CTCCAGTGAGGAAGCAGAACTTT	80	KDR
GGCCACCTCGTCCTGTAAAG	GCCGCTACTACGCCATGA	95	AKT1
CCAGGGAGTTTGCTGGACTTTC	GCTTGAGGACCAAGGGTGTG	82	SRC
ATGGAGACCGAACCGCCTCA	GCTCCAGCTTCCCTGAATGC	84	GNAS
CGAGTTATCGCACAAGTCGAC	CTGACAGCCTCTTGGGATGG	98	GNAS
CCCGTTCGAGATTGGCAG	GCTCGCTCTCTCTTATCTGGG	86	GNAS
CCAGACGCAAGATCCATCTCA	CCCTTCATCGTAGTACACGC	98	GNAS
GCAACTGCCTCTACGGCA	CATCTCTTCGGCTGGGCTA	99	GNAS
CTGCAGTGAGAAGGCAACCAAA	TTAGCAAAGCGGTCAGGGAACA	91	GNAS
CCTGGACAAGATCGACGTGAT	CAGTAATAATTGCCAATCTAAAGCAAAGGT	87	GNAS
CTGTTCGTAAAGAACGCTTTGCT	CCGGATGACCATGTTGTAGCTG	94	GNAS
ATTGTGAAGCAGATGAGGATCCTG	CCCACCTATACTTCCTAAAGGTTAGTATAAAGT	67	GNAS
GTGAGCTTTCAATCTCTCTTTAAAAGGG	CAGTATGATCTTCATGTTTGTTTGGTTTGT	74	GNAS
GGGTTTGGAGACAAAACCTATTCA	CTTAAACAAGAAAGATCTTCTAGAGGAGAAAAT	74	GNAQ
GGAGGCACAATTAGACCAGATTGTAC	GACAAAATTATCTACTCCCACTTCACGT	75	GNAQ
CAGCCAACCCTCCTTCACAA	GCTTCCTTTGCTTCTCCCAGAG	92	AKT1
ACGACCTCATGTGCCAGTG	CGCCTGTGCCTAGAGGTT	99	SRC
TCCATCCCTCCAAGCTATCGT	AGCTGTCTACACCCACAGATGA	96	AKT1
TCCCTCTCACCTGCAGAGAT	GAGCCCTTCCACAAGGTGA	100	CSF1R
AAAAATCAGAACTAATCAGTCCTTCAAAGC	CCAGACCAATGTCTGTCGTGT	87	ERBB4
CGTCCTGGGATTGCAGATTGG	GGATGTCACGTTCTCAAAGCAGT	92	GNA11
TTCAGCTTCCAGAGGAATCAAATAAACA	AGATCAATGGGAATTTGATCTTTCTAGTCA	80	ERBB4
CCGCTGTGTTGCAGCTAC	AGGTCGAAAGGGTACTCGATGAT	83	GNA11
CTTGGTACAGTTTATGAATTTGTCAATGTTACT	ATTGGCCAAAAATAAGTTTCTCAATCCC	77	ERBB4
ATGGAGGAGAGCAAAGCCCTGT	TAGTCCACCAGGTGCGAGTA	88	GNA11
TACCACTCACCTTTTGGGCAAAT	AGATAACTTTGTGGTAGATTCCAGTTCTTG	72	ERBB4
GCCAAGCCAAAGTCACAGATTTT	AACAGATGTGAAAGAGATCAGCTGT	91	KDR
GGTTGTCTAAAGTAATAACTCCATTGGCT	TGAAGAGGGTAAAAGTCCTTGGC	86	ERBB4
GCCACTTGGAAGCTGTAACAGA	AAACTTAGAAACATCACACTAACTCATGGA	79	KDR
CAGTTTCTTTCAAAATACGAAGTTGAGCT	GAGAGAGGACTGACTATCGGACT	72	ERBB4
TAAGAGACGATTGGAGGAGATGCA	AACATGGAGTCGTGTACATTACTGAG	74	KDR
CACCTCTGTTTCCAAGAATCTTCTCAA	CTGATTGCAGCTGGAGTAATTGG	78	ERBB4
ATGCGCAAAGAAGCCCTGGAG	GCCGCATTACCTAGAAGCAG	95	GNAS
GCCAGCAAGAATGCTTACCCTT	AAACTGTGTGGAAAAATGTCCAGATG	80	ERBB4
GGAGGGAGGAAAAGTACCCTC	TCCCGGAGTCGGGATCTTC	99	GNAS
ACTATATTTTCAAGCAAGATTGCTCTCAAA	CTCCAAACCATGTGAAAATCACAGATTTT	67	ERBB4
GGGCCAAGTACTTCATTCGAGA	CCATGGAACTGGGTAGCTGAAC	93	GNAS
CGCCACTGTCCATTCACAAAGA	GCCTTGCGCAAGTACTATGAAAA	93	ERBB4
CCCTTCGAGGCTGAACAGC	GGTCTGGCACCACTGAAGG	101	GNAS
AAAGAAGTTATGATAATCATAAAACCTCCACA	GGAATCCAGGAATGCTATGATAGACG	79	GNAQ
ATCATTCCATAAACTCTTTATTGCATCTACAT	TGGAAAGTAATAGGGTATTAAAACTGCCTTTTT	72	GNAQ
TGTGTCCATGGCTCTGATCATG	CAAGAGTACGTTTATCAAGCAGATGAGAA	84	GNAQ
TTCGAGACCGAGCCTGAGAC	GGGCTTCGCAACTTGAGAG	100	GNAS
CGTCGCTGCAAGCCAAAG	AATCCATGAAAACAAGGAGAATCTGGA	83	GNAS
CACCTGTGTCAACAGCACATTC	CCCTTAAAGATGCCATTTGGCTTG	88	EGFR
GTTTATTTTGAAATAGGAGCACCTAGGC	AATGTCTTTGAGTAGTATGTTGCTACAATCA	72	ATM
CCCATGTCTGAAGAAGAGAGCT	GTAATAGCAAGTGTACAACCCTGTGT	80	PDGFRA
CCCGATACGTGTGCCAGTTT	AGGATGGCTCTTACCTACACTGT	96	MPL
AGACATTCTTTCTGTGAGAAAATACTGGTG	AGAGTGCTTTCTTTGGTGAAGTTTCA	68	ATM
AGAAAACCATGGAAGTGATGAGAAACT	CTCTTCACATCAGTGACTTCCTGA	88	ATM
GTGTGATTAGTAACCCATTATTATTTCCTTTTT	ATTTTCCTTGTTTGGAATCTGAATGCC	68	ATM
GGTCAGAGAGAGAGCTCAGTTTATTC	GCTTGTGGAATAGAGAGTTTTGAGAAAGAT	78	ERBB4
CGAGAACCAGTTCAGAGTGGACTA	GTTCCTATATGGACACTGTGCTCA	84	GNAS
GAAAAATGTGATTGCCTGGGTGT	CCCAAAGGGTATTTGGGTACC	94	ERBB4
GGGTATGTGATAATTGTTCTAAAGAGAGC	GGGTTGGACTTATAAAATAAACACAATTCACAA	76	GNAQ
CAGCTATCTGGCAATTTCTATTCTGTACT	GCTGGATGAGGAAGGTTACATGA	87	ERBB4
GCTGGAAAAGTCATTCCTCTCACT	CATCTCAGCGTCTGTCAGAGT	92	SMARCB1
TGTATTTTTGCTTTACAAGCTTTAATTCGCA	ACTTCTCTATAGATGCCAATTAAATGGATGG	72	ERBB4
AGAAAATAGTTGCATCGTCACATGGTA	GGAGTGAAAACGTTTTATCTTCATGACAT	70	SMARCB1
AGCGACAAAATGGAAACATGGTAGA	AGAATGATGTTTTCTGTTCTGTAATTGCC	85	ERBB4
CCTATACTGACTGGGAGGACTTTTCT	GGTTCCTGTTGATGGTTGTGGA	91	SMARCB1
ATTCAGGATTCTCTGCCACAATAGG	ACAACCCTGACTACTGGAACCA	90	ERBB4
CCTCTCAGTGTCTGACTTCGAC	GGAGTAGTAGGCCACCAGCT	96	SRC
GTTGGCAAAGGTGTTGAGGTAC	GAACCCTTTTGTTTCTCGGAGAAAAA	90	ERBB4
ACGGAGACAGACCTGTCCT	TGATGCCAGATCCTGCATGAG	99	SRC
GGTCTCGAGCCATCCTTGAA	CAACTCCTTTCTAGTTACGAATATAGTGACATT	74	ERBB4
CCCAGGTGGTATTTTGGCAAGAT	GCAAGAGCGCTCGTACCTTT	81	SRC
CATGACCATGTAAACGTCAATAGTGC	GGAACTGATGACCTTTGGAGGAAAA	75	ERBB4
CTTGGGCCTCGTTTTCCCT	GCATCCTTGGGCTTGCTCTT	98	SRC
ATGATACTAAATAAGCCAACACACCACA	TTTGAGAATGGCTCCATCTGTGT	74	ERBB4
GGTCACTCCCAACCTGTCCTA	CACCTCGCGGTTCACCAT	92	SRC
TAAGCATAACTCATTCATCGCCACAT	GGCAAGATATTGTTCGGAACCCAT	88	ERBB4
CTCAGGCATGGCGTACGT	GTACTCATTGTCTTCAATGAGCCGA	92	SRC
CCAATGAATGGTGTCTGCATAACAAAG	TTACCTTTTCATCAACAAGCAGTTTGAC	71	ERBB4
TGCCCTGACCTTTCTCGTTC	CCTTTGTGGTGAGCTCAGTCA	98	SRC
TTTTTAATGAAGATACCAGATCCTTGGAGATTT	CTTCTGAAGGTGATCTTTTATTACTTCCCA	76	ATM
TGACCACCAGTATAGTTCCAGGA	ACCCTCTAACTGATAGAATAAGAGCCATTT	71	ATM
CTAAATTTTCATTTTGGAAGTTCACTGGTCT	TTGCTTTAATCACATGCGATGGAAAAT	81	ATM
TGTTTTAAGATTGTTCCAGGACACGAA	TTTCTCTCATTCCTTCCTGAGCTTTC	71	ATM
GTTAACCAAAGTCTTGCCACAAGA	AAGTTTGAAGTCTGTGCTCTAAAATTTCAT	70	JAK2
GACCGGGATCCTACACAGTTTG	AGAAACGCTCTTAAGTTTTTCCTAAATGAA	75	JAK2
CTACAGAAGGCAGAAGTACAGATGAG	ACTTTTCCCTTTGGGCATAGCA	91	APC
AGAACTAACCTCCAACCAACAATCAG	CCCTCTGTCTGGTATGTCTTTGGA	88	APC
AGTGTTTTGAGGAATTTGTCTTGGC	AGTACTAAATGTTTTCAAAGGTACCTTTTTAAC	73	APC
CTTGAACATTTGTTTGTTGCTTGTTTAGG	GCATGACGCCATATTCTTTTAGAGCA	84	PTPN11
TCATGCGTGTTAGGAACGTCAA	CCATCAACAGTTCCCAAAGTCTCTAG	76	PTPN11
ATGGGCAACTTCTCTGTTTCTTTTTC	TCCATGTAAAATAGAGCCATAGTGGAGA	85	EGFR
AGTCTGTGTCCTTAGGTCCTGA	CTATCTCTGTCTTCTGCAGTGACAAG	84	ERBB4
GCTCAGAGAGGGAGACTGGTG	GTAGAGGCAGCCAGAGACGGTA	88	SRC
CCAAGTACTCCTCAGCATCCATC	CATATTTGTGTCTGATGGGCAATCTTTC	88	ERBB4
ATCCTGGATCCCTGTGTGGTA	GGAAGGCCTCTGGAGACATC	97	SRC
GGAAACATGGTAAGCAAAGACCG	ATCCATCATTCCATTTTTCTTTCCTATTAGAG	84	ERBB4
GTTGTATGCTGTGGTTTCAGAGGA	GACATGAGAGGAAATGAGGCTCAT	90	SRC
GCCATTTTGGATATATTCCTTACCTGTCA	GGACAAAACTTTATGAGGATCGATATGC	67	ERBB4
CCATCTCACCAAACTGCAGGTT	TACCAGGTCCGCTGGAAGAT	84	CSF1R
TTCAATATGAAAACTGTTCCAGGTTAGGAA	TAACATTGGATCACAACTGCTGCTTAA	68	ERBB4
TGAGCTGGCTTTGAAGACAGAC	CGAGGGAGGCGTCGACTATA	86	CSF1R
GCTCGTGGACATACTCCAACAG	GGAAGCTCTGATCATGGCAAGT	86	ERBB4
CTCAGCCTTCCTTCGCAGA	CTCATGCTCCTGTTCATGGAGG	96	CSF1R
CCAGAGGCATGAAATGGACCAA	ACGTTGCCATAAGTCCTGTACTG	94	ERBB4
GGAGACTAAAACAGCCTGAGGA	GCCACAGCTTGGCATGGTAA	85	CSF1R
TGTTTGGTCCAAAGAAGAATGGGA	GACAACACTCTTCAGCACAATCAAC	88	ERBB4
TTGGGAGGAGGCTCAGACT	CCTCAGCACCAACAACGCTA	89	CSF1R
CCTTCAGGGACTGGAACTGTAGA	GTGACAGCCTTATTTTACTCCGGAAT	80	ERBB4
TACAGGGTCCAGTGAGGTGAT	GTCAGGGAATCCCAGTGATAGAG	88	CSF1R
ATGTTTGGTGGCCATGACTGTA	CCAACTTTCAACACATTTTCACCATATTTC	78	ERBB4
CTTCCATCCCTTTCCAGCGAA	TCTATAAACTGGTGAAGGATGGATACCAA	74	CSF1R
CCAGGACAGGGTTCCTCTGA	CACCTCCGTGACGAGGTT	91	HNF1A
TGGGTACAGGCTCCCAGAA	CTTTGGGACTGTGGTTCTTCCT	91	CSF1R
GCCCTCTACAGCCACAAGC	GCCTGGACCTTACCTGCTTG	96	HNF1A
ATGTGTCCTTGGTGGTAGCATTAG	GGCTCAACCTCAAAGTCATGGT	79	CSF1R
TCAGCCATGAGACAATAAATCCTTGT	ACCGACTAACAGCATTTCCAAAGA	89	MLH1
ATCTTAAGACCTCGCTTTTGCCA	TTTAAAGCTTTTCTCCTCGTGGCTAT	86	MLH1
CAGCTCGTTCATCGGGACTT	ACCTGGCTCCTCTTCACGTA	87	RET
CGTGTGATTGATGGACCCGTATT	GTTAAATAACCGCCTTTGCTTTGATCTT	86	FGFR2
CATTGATTTCTGTTTTTACCTCCTAAAGAACTG	TCCAATTTCGACACAACCCTGT	83	RB1
TTTCCTTCTTTGATTTAGGTTTCTGCTTTG	CCACAGTTCACCTGATGATGGT	74	PIK3CA
TTCAACAGCCACACACTACATCA	TTCTAACTCAGAGGAATACACAAACACC	88	PIK3CA
TCTCATACACAGATGTATTGCTTGGTAAAAG	TAAATATTTTTCCAAGCACCGAACAGCAAAACC	70	PIK3CA
ATTTTTGAAAGCTGTTTCATATAGATTTTGGA	GCATTCTTGGGCTCCTTTACTAATCA	81	PIK3CA
CTTTGTCTTCGTGATTTGTAGGAGTCA	GCACGAGGAAGATCAGGAATGTA	88	PIK3CA
GCCGGAGCTTCCTTAACG	TCTTCCTCGTACTCTAGGCACTC	94	GNAS
CAGGAGGCTCTGAACCTCTTC	GGGTCTGGAATGCTTGCAC	94	GNAS
TATGGACAGCCTGCGACCAGT	CTTCTGTACTCAGCAGGCTGT	93	HNF1A
GAGGTTCTGCTCAGAGCTCAAG	CTGGATCAATGGGTGGATGACAA	79	CSF1R
CTTGTTTGCCTCTGCAGTGTC	CCATCTGGGTGGAGATGAAGG	85	HNF1A
CACGCACCTTTCTGCACTTT	CCTGGCATGGCTTCACCAT	87	CSF1R
TGCAAGGAGTTTGGTTTGTGTCT	GTCTGCAGCTGGCTCAGTTTA	95	HNF1A
ATGCCAGGGCGAGAAGGAGTA	TTCGAGGACCAGGACGCACTA	86	CSF1R
TACCTCCTGGCTGGAGAAGG	CATCGTCGTCCGTCTCGT	88	HNF1A
CGAATCCGCACCAGCTCT	AGGGAGGAGAGCAATATCTCTATCATG	79	CSF1R
AGCCCTTGCTGAGCAGATC	CCAGTGGTATCGACCACCT	87	HNF1A
CCCTTCTCCTTTTCCCTTGTTATCA	GGTGTGGACACCTATGTGGAGA	77	CSF1R
CACCTGGTACGTCCGCAA	GGGATGGTGAAGCTTCCAGC	88	HNF1A
CCCATCGTCACTCATCCAGC	CACTTCTCCAGCCAAGTAGCC	83	CSF1R
CCTCCCTGGGTCCTACGTT	CTCTTCCAGCTCCTGGATTCTG	84	HNF1A
CACCACCCTGATGCTTACCTAC	GACCCTCAACCTCGATCAAGTAG	79	CSF1R
CCCTCGTAGGTCTCAGCAG	AAGTGAGGCCATGATGAGGTTC	84	HNF1A
GTACAATAGCAGCAGGAGCAGCA	CTCACTGCTTTGCTTCATGCC	86	CSF1R
GGTTTCAGCTCCTTGTTTGGGT	CTGAAATCAACCCTCACCTAACTCAG	86	ALK
GCAGAATGTGGCTCAGAGCTT	TGCAGTGGCCACACTGATAG	87	CSF1R
CCTCATCCACGGACTCAGGAT	AGAGCTACTGCTGGTCTTACCT	82	ALK
TGCCAGAGCCGTTGATGAAT	GGCACAGGGAAGTAGGTACTG	84	CSF1R
CTGCCGTGGAAAGCAGCAG	TGTTCAGAGCCTCTTCCCATCT	93	ALK
CTTACATTGCCCTTGACAATGTAGTT	GCTTTCCCTCAGTGCATCCA	93	CSF1R
CCCAATGCAGCGAACAATGTTC	GCTGAAAATGTAACTTTGTATCCTGTTCCT	79	ALK
CTGCACTCTCACCAACCCTC	CCTCCTCTGGGAGATCTTCTCA	96	CSF1R
TTCCTCCTTTTTAACAACAGCTGGA	GACCCTTAAAACTGGCTCTAGAACTTT	86	FLT3
GCTCTCACCTCCATGCAGTTC	CCATGGGTCCTTCACCAAGATTTAC	79	JAK3
GCCACTAAACACTTCCCAGACC	TTTCATTCCCTCAGTGCTCACC	85	JAK3
GAAATCCACCAAGCCTTTGAAACAA	ACCAGGAAGTGAACCGAATGAC	92	ABL1
CCATCCCAGTTCTGATTCTGCT	CCGCCTCCTTCTTCATCATAGTAATAAAC	75	CDH1
GCCTTCATCCCTCTCATATCAACC	CTAGAGATGGCGAGGCACA	90	ABL1
TGTATGAGCTGCTAGAGAAGGACTAC	ATTTCCTGGAATGCCCACATATACTC	80	ABL1
GGGTGAGCTCAAACGTCAGA	TCACCAACACCACCTGATTCTC	97	CSF1R
CCTCAAACACTATCAGAGAGGCAT	CCTCATTCATATTGGTCACCATCTCA	77	KDR
TCTTTAGGGCCTGTTCACAATGAG	TTCCATTAAAGCCTGTGTTTGTGC	91	SMAD4
GGGTTTTTCCTGTGGCTGAAAA	CTACATATAAGACAGCACACAAGAATCGA	87	MET
GCTACGATGCAAGAGTACACACTC	ATATACCTTCTGGAAAAGTAGCTCGGTA	73	MET
CACACAGCCAGGAGTCTTTTCTT	GCAACAGACTTTAAAGAAGTTGTGTTTTAC	76	KRAS
TCAAAGTTCGATCAGCAGCTGTT	TTTTTCTTGATGTTCTAAAAGGCTGTAGA	85	ATM
TCATAGGGCACCACCACACTAT	CCTCTGATTCCTCACTGATTGCT	85	TP53
CCGTCAACTAGAACATGATAGAGCT	GCGCTTAAATTTCTCAACTTCTTTCTGAAA	84	ATM
GAGCCAGATAGTTTGTATGGCTGT	GGGTTTTACACACACATAACTCCTTCATAA	71	ATM
ATTACAGGTGCTTATGAATCAACAAAATGG	CGGCAATATTACGAAATCCTGAAGAATACT	66	ATM
CAGAAACACTCCCAGCTTCTCAA	CCTTAATACATTCTCTTTGTGAGTTGTCCA	76	ATM
AACCCAGCCTCCTTGAAATCC	ATGGGTGGGCACACAGACAG	97	MPL
GGTAATATATGCCTTTTGAGCTGTCTTGA	CAATAACTCCACCACAATCTCTGGTAAAT	71	ATM
CAGTATCATCAAGGCCATGGGT	GTGGAGTTCTTGGGATCTCTGG	87	MPL
TCAGAAAGAAACAGAATGTCTGAGAATAGC	TGTTTGCACATTTGATGAAGTATTTGACC	65	ATM
CATACAGCTGATTGCCACAGAAAC	AGGTCTGCTTTGGTCCATCTTG	78	MPL
AAACAAAAGTGTTGTCTTCATGCTAGTT	TATTGCCATCTTGGATAACTGCAACAA	69	ATM
AAGAGAAAACAAATCCAGGACTACAGAC	CCCAGGTAGCTGTGAACAGTAC	79	MPL
AGACCTGCACCGGGTCCTAG	GACCTTGAACAAGTTGTATTGTTGGG	93	MPL
ACTCTGACCCTTCTGACCGAT	GATCTCCCTCCAGTGCAAGTTT	81	MPL
CCCTTCCACATAAACATGCCT	CAAGTGAGGTCCTCAAATGTTCG	83	MPL
GAGACCTGTTATCAACTCCGATACAC	CTTTCACTCCTGCTAACAGGCAT	84	MPL
TGTTACCTGTCAATGGCAGCAA	CCCATGACACCAACCTCAATCAG	79	MPL
CAGCCTGGCAACTCCTACTG	CCTTTGTTGACTCACCTGCATCT	86	MPL
GCCGAAGTCTGACCCTTTTTGT	ACCTGTAGTGTGCAGGAAACTG	83	MPL
CGGACTCAGCGAGTCCTCTT	GTATCCGTGCTGAGCTGGAA	94	MPL
TCATGACAGAATGCTGGAACAATAATGTA	CTACTTTGGTCTCAGAATGAAGGTCAT	73	JAK2
TTGCAGGTAAAATCAAGAGTCCACA	GAACCACTCCAAAGCTCCAAAC	90	JAK2
TGAAGTAGAGGACCCTCATAAGGC	GGCAAACACCACTCCCTGT	96	JAK3
GTTCTAGCAGCTCAAGCAAACAC	CACTGGAGTTGGGATCTGAGATG	93	APC
GGGTAAGAATGTGCACTTTGAAAAGC	GCGGGAGATTCAGATCCTCAAAG	90	JAK3
GAATAACAACACAAAGAAGCGAGATTCC	GTTTCATTCTTCCTCTCTTTTAAACAGATGTC	64	APC
GTGCTGCAGCTGTTTCACG	CATCCAGGTGCCTGGACATC	85	JAK3
CCCTCAGTTCTCGGGTCCT	GAGACGTCAATGCCTGCAG	101	APC
CCCAGACTGGATGTCAGTCT	CCACGGTCTGGGAAGTGTT	96	JAK3
CTCTTACGGCAAGGTGAAGGA	CAAGCCATACTTACTTCTTCACGTTG	83	STK11
CCCACTTGTCAGCTTCCAAG	CAGGGCAAGGAAGTGGATCC	84	JAK3
ATGTTCACGGAGGGCGAGC	CCCATCAGGTACTTGCCGATG	84	STK11
GCCACCTCCTTGCAGAAGAAG	CTCTGACGCTTGTCCCTCG	88	JAK3
CAGGCCATCATCCTGACGTT	TTCTGCTTCTCTTCGTTGTATAACACAT	88	STK11
CATGCGAAGCCACACTGAC	GGCATGAGCTGCGTGATGA	98	EGFR
GTGCCGGAGAAGCGTTTC	TCAATGAATATCAGGACAAGCAGTGT	94	STK11
GGTGACCCTTGTCTCTGTGTTC	GCACTTTGATCTTTTTGAATTCAGTTTCCT	73	EGFR
AGAAACATCCTCCGGCTGAAG	AAGAGGTCCTCGTCCTCGT	89	STK11
CACCAGAGTGATGTGTGGAGT	TTCCCTCCCTTCACATGCTG	94	ERBB2
GCAGCAGCTGTAAGTGCG	CTGTCCATTGTGACTGGCCT	101	STK11
CAGAAGGTCTACATGGGTGCTT	CCAGCCCGAAGTCTGTAATTTTG	92	ERBB2
CCTTAGGAGCGTCCAGGTATC	GCCGGTTCGTACTCAAGC	100	STK11
GGAAGGTGAAGGTGCTTGGATC	CATCAGAACTGCCGACCACA	82	ERBB2
CCCGCAGGTACTTCTGTCA	CAGGTCGGAGATTTTGAGGGT	87	STK11
CCCAAACTAGCCCTCAATCCC	CTTGATGAGGATCCCAAAGACCA	80	ERBB2
GGTGACCCAGCAGTGAGTTTTT	TACCTGTATGCACACTTTCCATCAG	80	MLH1
TGGAAGTTTACGAGACTATCTTCAAAAACA	GGTTGCTTCATCTACAGCAAATAATCAG	66	JAK2
TCACATACATTGAGAAGAGTAAAAGTCCAC	GTATGCATGTAGCAAAATTGTACTTGTACC	68	JAK2
TTTGCTGATGTTTCAATAAAAGGAATTCCA	AGAGTTAAGGACTCTGAAGATGTACCTATG	76	KRAS
GGAAGCTTTGTCTTTCGTGTCATTAAT	CGAAATTGGGCCATGACAGTTG	86	JAK2
TGTCAGCTTATTATATTCAATTTAAACCCACCT	CAATGAGGGACCAGTACATGAGG	68	KRAS
AAACTTGGTATTTCCATCCTAATGTGATGT	GCTCTTCAGTACTATGCTGAAGCTTTTT	80	JAK2
GGTCAGAGAAACCTTTATCTGTATCAAAGA	GAGTGCCTTGACGATACAGCTAATT	80	KRAS
GAGACTTTGAAAGGGAAATTGAAATCCTG	GGATGCCAAACACATACCTTGAATTTAAAA	76	JAK2
GCCTGGGCATCCTTGAGTTC	GAACCATCTTTTAACTCAGGTACTGTGTAT	83	TP53
TCCATTGTGACTATCCCTCCCTTT	TGCTGAAGTTCTTCTTTGTCCCA	89	JAK2
AAATATTCTCCATCCAGTGGTTTCTTCTTT	GGAGACCAAGGGTGCAGTTATG	75	TP53
AATTGTTACCAGATGGAAACTGTTCG	CCACATAAACAATCCATGACCAGTAATTTA	76	JAK2
TCAACTTACGACGAGTTTATCAGGAAG	ACCAGACCAGCTTTCAAAAAGAAAATTG	69	TP53
GGGTACCACCTGAATGCATTGA	TAAACTTACTCTTTGAGAATCCAGAGCAC	88	JAK2
CTCACCATCGCTATCTGAGCA	GCTGTGGGTTGATTCCACAC	91	TP53
GATGACACTTGGTCATAATATTATGGTGCT	CTGCATCGAAGTACATACAGTCCA	81	JAK2
GGCATTGAAGTCTCATGGAAGC	TCATCTTCTGTCCCTTCCCAGA	94	TP53
CAGGGATCTGGCAACGAGAAAT	GGGACTTTCACCAGGTTCTTTTACTTTAT	78	JAK2
TCTGGCATTCTGGGAGCTTC	TCTGACTGCTCTTTTCACCCATC	91	TP53
GTGAAACAGAAAGGATCTGGTATCCA	CCATTTTGCCTTTTAGCATTAAGTGAGTTA	76	JAK2
CTTGCTTACCTCGCTTAGTGCT	TACTGGGACGGAACAGCTTTG	94	TP53
TACTTTCCTCGTTGGTATTGCAGTG	TATAATCATACCTGAGCAAAGAGGTAAGACA	68	JAK2
GGCTCCTGACCTGGAGTCTT	CCTAGGTTGGCTCTGACTGTAC	82	TP53
GACAGAAATGGAGGGAACATCCA	AGATTTCCCAAGGGAATGGTAAAGATAC	75	JAK2
CGGAGACTGCTGCAGGAAA	CATCGCTCCGCTAGGTGTC	98	ERBB2
GATGGTTAAATCCACAACAAGTCTGAC	GAGGCTGCAGAAATGCATCAAG	75	MLH1
ACACAGGGCCTGGGACTAGC	GGATGACCACAAAGCGCTG	100	ERBB2
GGGCTAGGCAGCAAGATGAG	AGGTCCTCTCTTCTCTGACATTTCT	79	MLH1
GTGACTGTGTGGGAGCTGAT	GATCATGTAGACATCAATGGTGCAGAT	87	ERBB2
GCTTTAAGTAGTCTGTGATCTCCGTT	CTTTACTGAGGCTTTCAAAACATTCCTTTT	73	MLH1
TGTTTCAGTGACTCCTTCACACATAC	TTCTCTCTCTAAAACACTGATTTCCCATTT	82	EGFR
AGTAAAGAATGCGCTATGTTCTATTCCA	GTATGAGGTCCTGTCCTAGTCCT	74	MLH1
AGGCATTTCCTGTGAAATAATACTGGTATG	GAACTCAAAGTACATGAACTTGTCTTCC	81	PTEN
CACGAGGCACTGAGGTGATT	GATGCGGTTCACCACTGTCT	93	MLH1
TTCTTTCTTAGTACTGCTCCATTTGGG	CAGCAAGTCCTGGTAGCAAAG	91	MLH1
CAAACTCCTGGAAGTGGACTGT	TTTGTATAGATCAGGCAGGTTAGCAAG	78	MLH1
CGAATACACCAACAAGTAATGATGCCT	CCTTCAGCTTCTTTACCAAACTTTCAATTG	68	SMAD4
ACACTACCCAATGCCTCAACC	CCAAAATAATGTGATGGAATGATAAACCAAGAT	81	MLH1
TTCTATATAGCTCCATCAAGTATGATGGTGA	GCACGATTACTTGGTGGATGCT	71	SMAD4
CTTTTGTTTTTCTTTTCCAGGTATTCAGTACA	CTCCACCAGCAAACTATTAAAAATCCC	80	MLH1
GGAGAATGAAATACAGAAAGCTGGTCA	GTCATCAACACCAATTCCAGCA	90	SMAD4
CCATGCTTGCCTTAGATAGTCCA	AGAGAAATAGTCTGCAAGCATCTCAG	75	MLH1
TATGCATACTCAGGATGAGTTTTGTGAAA	GCATGGTATGAAGTACTTCGTCTAGGA	81	SMAD4
CCAAAATGCAACCCACAAAATTTGG	ATTTCCTTTCGGGAATCATCTTCCA	88	MLH1
GCATCGACAGAGACATACAGCA	CAACTTGCTGACTACATCTGATTCTAGAA	82	SMAD4
CCGGAGAAGGATCATTAACCTCA	CATTTCCAAAACCTTGGCAGTTGA	86	MLH1
CTGGAAGTAGGACTGCACCAT	AAAAATAGCCCTTACAACAAAAACAAGAG	82	SMAD4
TTTTCAGTGAAGAACTGTTCTACCAGATAC	AGCTACTATTTTCAGAAACGATCAGTTGAA	70	MLH1
GGGAACAAGAAGTGGAGAATGTCAG	TCATCTCTCCTCCCTGCTTCTG	87	TP53
GGAAATCTGAGGCAGATTATCTGACC	ATCCATGCATAAAAAGGAAAATGCTGTT	70	JAK2
GGCTGTTGTGCCCTTCTCTTAG	ACACAAGAACTTGAGCATGTCTAAGAA	75	ATM
GCCCATCTAATTTTAAAAAGAAGGTTGGT	GGTTTGCTAATTCTGCCCACTTTG	85	JAK2
GTGTGTAACTACTGCTCAGACCAA	ATTTAACGTAACTCACCATATGCAGGT	85	ATM
CGAGATCTTAACAGTTTGTTTACTCCAGG	CCCAAATGACATCAAGAAAATGTTTTAAAGGAA	75	JAK2
TTCACTGTATTCTTTACTTTAGGTGTTGCT	AGACACCTTCAACACCCGTAATG	76	ATM
AAATGGCTCTGTAAATTCTACCCGTT	GCTTTCATTTGAACCCTCTTGGTTT	82	JAK2
AAGATGTTGTTGTCCCTACTATGGAAATT	TTGCCAATATTTAACCAATTTTGACCTACA	80	ATM
GCCGAGTTGTAACTATCCATAAGCA	CCTACCAGAAAATAATTTTGGTACTAAGATTCT	76	JAK2
AAAGTATCCTGCAAGTTTACCTAACTGT	CAACTTCCGTAAGGCATCGTAAC	73	ATM
CTTACGATGAGATATTTCCTTCAAATTTTTGGT	GGCTATTCTCATCATATCTAACACTGCC	78	JAK2
AACCTAGAAAGCTCACAAAAGTCAGATTTA	ATTATGGCTCCAAGTAAGCCAAAGT	69	ATM
TTTTTCAGATAAATCAAACCTTCTAGTCTTCA	CTTCATTTCTGATTTTGTGAAACACCATTTG	61	JAK2
GGACTTGGTGATAGACATGTACAGAATATC	GCAAACAACATTCCATGATGACCAAATATT	79	ATM
AAGTATGATGAGCAAGCTTTCTCACA	AAACAAAAACAGATGCTCTGAGAAAGG	71	JAK2
CTACGAACATATGAACACGAAGCAATG	GATGGCTTTACCAAATCTGGGAAAAA	80	ATM
ATTTTAATGCAGATATTCTGGTTCAGGAGT	CCATGCCAACTGTTTAGCAACTTC	70	JAK2
TCTTTGACTTATCTCACAGCAAAGAAG	TACCTGGCATATTTGAGACTTTCATAAAATGT	67	ATM
GCTTGAACATACTAAATGCTCCAGTACT	TCCTGTCTTCTTCTCTGATAAGCAGAATAT	81	JAK2
CTCACCAAACACCTTGTAGAACTCT	CTTTTTCCCTCAGGCTTTCTGTTTTT	87	ATM
ACAGGAAGACAGGAAATCCTCCTT	ACTGCCCAAGTAAAGCTTAGTAACATTAT	72	JAK2
ATTCAGAAACTCTTGTCCGGTGTT	CTCCTACCTTGGCTTTCTGGAATAATT	74	ATM
AAAGGTGGTAACTTCTTTTTCAATTTTTAGAT	GATAGTCTTGGATCTTTGCTCGAATACA	77	JAK2
GCTGGTCGGAAAGGATTTCCTC	GACACTATCACATTTTAAGTCAAACGCAT	74	SMAD4
GGGAATTCAAAGAGATTTGGAAAAATGAGT	GCTAAATCCTCAAAGGACTGCAGTT	79	MLH1
CCCTTTCTTTTAGGAAAAACTGTGTTGT	GAACATCCATTTCAAAGTAAGCAATGGAA	81	SMAD4
CCCAGCTGTGATCCATGAGAAC	ACTGCCTTGTACCATTCATGTTCC	78	SMARCB1
CAGGTAGGAGAGACATTTAAGGTTCC	CTTGCTCTCTCAATGGCTTCTGT	90	SMAD4
CCCTCCTCGTAGCGAGAA	GTCCTGGTCGCGGATCTT	96	SMARCB1
AATGGTTCATGAACTTTTGTAATCTTTGGTTT	CTGCAGTGTTAATCCTGAGAGATCTT	81	SMAD4
CCTTCCCTCTCCTGATTTCAGAGAA	GGACTCGATCTGCTGTCTGATG	86	SMARCB1
TTTTTCTTCCTAAGGTTGCACATAGG	GCTTCTCTGTCTAAGTAGTAACTCTGTACA	71	SMAD4
AGACCAGCGCGTCATCATC	AAAGACGGGCTTCTGCTGA	86	SMARCB1
GCACCTGGAGATGCTGTTCATA	CTTCCACCCAGATTTCAATTCTTTTGAC	74	SMAD4
CTTGATGTGCTGCATCCACTTG	GAGGCTTTTAACAGGGTCACACT	85	SMARCB1
GTTAATGTCTTCTTGTTCCTCTAGGTCA	GGTAAGTAGCTGGCTGACCAGTA	86	SMAD4
CATTTCCCTGGTGGACCAGTTT	TGTATGCGATGGTGGTGACAAA	80	SMARCB1
TTTTTCTTAAAAGGTCTTTGATTTGCGT	CTATTCCACCTACTGATCCTGGG	88	SMAD4
TGAGCTGGCATCAGAAGACCTA	CGTGAGAAAGCCTCAAAGGTATCAC	84	SMARCB1
AAATGGAGCTCATCCTAGTAAATGTGTT	AGGAAACGTAGCAAGTTTTTAAATCTGC	70	SMAD4
AGGACGACGGCGAGTTCTA	CGATGAATGGAGACGCGC	91	SMARCB1
CTCAGGAGTCTCCACATGGAAG	ATGCACGCAGACAGAGGCTCT	96	AKT1
TCCTAAAGTACACTTTCAATTCCCTAGGT	GCTGTTTACAGAATTCAGGATGGGTA	80	BRAF
CTGTCCTGCTGTGTGTGTTCTA	GAATTTCTACCATGATTTAAAAATCCACCA	86	APC
ATCTCTGTCCAAGTCCTGTGAAATTTT	GCTTTGTGTATGCCTATAATTGAAACTGT	80	FLT3
GAAAAGGACCTATTAGATGATTCAGATGATGAT	TGGAGGTAATTTTGAAGCAGTCTGG	73	APC
TCTGTAGCATAAAATGGCTGATCCATT	TGAATGGCTGCAATTGTCTAATGTTTTC	71	FLT3
GTTGGGTACAGTCATGGTAATGCA	AGGATTTTCTAAGCACGTTTCTGCT	90	ATM
CATATTTTGACAAGGAAGCGAATAAGGTAC	CAGACTGCAGAGTTTCCAGATTTATAAGA	67	JAK2
AATTTCCCAAATGGAATTATTTAAATAGTTGCC	AATTTAAGAGTTCTTGACATTTTAGCCTAGG	66	ATM
TGCCTTCTACACAGAGAAATTTGAAGTAAA	CTTTATGTTTCCCTCTTGACCACTGAA	67	JAK2
CAGACTGTACTTCCATACTTGATTCATGAT	ATCGGCTCGTTTGCGAGA	84	ATM
GTATTTTCTTGTTCCTACTTCGTTCTCCA	CCGTAGTCTCCTACTTCTCTTCGTAC	83	JAK2
CAGGCTTAACCAATACGTGTTAAAAGC	GTTCCAGTTGTCTTCGAAGATCCT	87	ATM
GTCAACTGCATGAAACAGAAGTTCTT	CATATGAGAGCACATCTTTAAACAGCATAA	69	JAK2
ATCTTAGCAGCTCTTACTATCTTCCTCA	AGAATCATTAAGCCTATGTTGAGTCCAAAT	70	ATM
TGAAAGTGGGTTTGTTTTAGGAATTTATGC	GCATCCATCTGGTCTTGGTAATCTTC	68	JAK2
AAGAAGTCATTATTGAATTATTTCAACTGCAA	ACTTAGACTTCTATGTTTGAATGAAGAAGCA	72	ATM
GGGTTCACCTGTACTGGTGG	GGACATCCTGGATACCGCC	100	HRAS
TTTCCGTTACTTCTGCATGGAAAAATTC	CCAAACAACAAAGTGCTCAATCTACTATAT	81	ATM
TGTCCAACAGGCACGTCTC	ATGAGAGGTACCAGGGAGAGGCT	94	HRAS
GCTGATCCTTATTCAAAATGGGCCAT	CCCATTACCTATTGATTGACTCTGCA	86	ATM
TGCCGAGATTCCACAGTGC	CGTAGCCAGCTCTCGCTTTC	86	HRAS
ACACATAAACAAGAAGGAAGAAGGTGT	CAGCAAGCATTGTTCTTTGTGATTTTT	79	ATM
GCCAGGCTCACCTCTATAGTG	GCGATGACGGAATATAAGCTGGT	80	HRAS
AACTCTGAGAAGTTTAAATGTTGGGTAGTT	ACCATCTGAGGTCTCCTACTTCTG	70	ATM
GCACACACTTGCAGCTCATG	CCTGATCCCATCCCTCCTTTC	95	HRAS
TCAGAAGTGTTGAGGCACTTTGT	GAGTAACACAGCAAGAAAGTAACGTTTC	73	ATM
ATTTTACAGAGTAACAGACTAGCTAGAGACA	CTTACCTGTGACTCCATAGAAAATCTTTCTC	76	PIK3CA
GTTACATGAGCCAGCAAATTCTAGTG	TGAAGGTGTCAACCAATAAACTTCTTTAAA	79	ATM
GTGTTAAAATGCCTCCTTCATAACCTG	CACAGATTTGACACTTACTCTCCATTAAAC	81	GNAS
TCGATCTAATTCAGAAATTTCAGGCCAA	GACTTGTACTTGAGGAGCTATTTCGAA	69	APC
CCCAAATCCATCTCTCTGCTGAA	CAGATGGTAATCAGTGTTCTGTCTCTTT	73	FLT3
CCTATTATGACTTGTCACAATGTCACCA	TCGAGTGATGATTGGGAGATTCCT	86	BRAF
TTGCTTTTACCTTTTTGTACTTGTGACAAAT	GAGTGACACTCTTTTGTTGCAGG	84	FLT3
GCTTTGGAAGCTCTCAGGGTA	CCATCGCGATGTCGCAC	100	CDKN2A
GAAGTGGGTTACCTGACAGTGT	GCTCCTTTCTTTGACAGAAAAAGCA	92	FLT3
GCCTCAATTCTTACCATCCACAAAATG	CTTCATGAAGACCTCACAGTAAAAATAGGT	67	BRAF
AAGCTGATTGACTGGGATGCTT	GCAACTACTTTGAGATGAGTACCTATTCAA	85	FLT3
GGCTCCTCATTCCTCTTCCTTG	GCGCTTCGATTCTCCGGAAAA	81	CDKN2A
GTGAACAGCCTGGTGCATTC	TTTTCTAATTGCAGCTGTAAAGAAGAAAG	87	FLT3
GGGAAGAAAAGTGTTTTGAAATGTGTTT	ACTAGAGTGTCTGTGTAATCAAACAAGTTT	68	PIK3CA
TTGGAAACTCCCATTTGAGATCATATTCA	TGACTCATCATTTCATCTCTGAAGCAA	82	FLT3
TTTGAATCTTTGGCCAGTACCTCA	ATAAGAGAGAAGGTTTGACTGCCATAAAAA	84	PIK3CA
CATCTGCCAGCTGACATCCTAA	TCTTCATCTTGTTCCTTGTTCTATTGCTTT	77	FLT3
ATTCGACAGCATGCCAATCTCT	CCAAAGCCTCTTGCTCAGTTTTATCT	90	PIK3CA
GCAATTCAGGGAGCTGTGCTT	AGCTCAGGGACAGTGTACGA	90	FLT3
TTCATGAAACAAATGAATGATGCACATCA	CCAGAGTGAGCTTTCATTTTCTCAGTTA	68	PIK3CA
AATCCAGACTATTAGTTAATTGTTCCTGCA	GCAAAGCTGTTCATGTGAACCATG	71	FLT3
TACTGTTTCGGTTGGCTTTGGT	TGGCTTACTGGAAGTTGACTTTGTC	85	GNAS
CTTTGCACCTTATCCATAAGGGTTC	TCTTTTGTGATGAGGCAAAAATCACTTTT	84	FLT3
TGACAGTGTTGTTGATTAGTTCAAGCT	GTACTCGTTGGAGCGTTCGTA	90	GNAS
ACTGGTCAACGAAGTGTGTTTGA	TTCAAGGAACACAATTTCAGTTTTTACCC	87	FLT3
TTGATTGCTGCATATTTCAGATATTTCTTTCC	CTTACCTTACTACATCATCAATATTGTTCCTGT	73	PTEN
GCAGACTTTAAGGGATACAAGTTAAAATAAACA	AAGTTGCCAAAGGAATGGAATTTCTG	80	FLT3
ACTTTAATGCTGATGGTATTAAAACAGTTTT	ATCACCAGATGTGGAATCAAAACCT	82	ATM
CACAGCAGGGTCTTCTCTGTTT	GCCAGCCCAAAATCTGTGATCTT	86	EGFR
GCTAATCAGATTCAAGAGGACTGGAA	CCTTGGTAGCAGTCTCTCTTTGC	89	ATM
GCCTCCTGGACTATGTCCG	GGATCCTGGCTCCTTATCTCCC	87	EGFR
AGTTATAAAATAACTGATGTGTTCTGTTAAGCT	TGGTTTAAAATAGTTTTACAAACATCTTGGTCA	58	ATM
GCACCATCTCACAATTGCCAGT	CCTTGTTGGCTTTCGGAGATGT	93	EGFR
CTTCATGTAGTGAAAAACCTAGGTCAAAG	CAGATAGCAAAAGAAAAATAGGACCACAAA	80	ATM
AGTTCATTATCATCTTTGTCATCAGCTGA	AGCTGACCTAGTTCCAATCTTTTCTTTT	68	APC
CAGGCATCTAACAAAGGAGAGGAAATATATATT	GACTGCTTTAAAATTTTCAATGGAGATCTTACT	65	ATM
TGAAGATCCTGTGAGCGAAGTTC	CTCCTGAAGAAAATTCAACAGCTTTGT	74	APC
GTTTCTCTTCCTTGAAGGCATCCTT	CGTTAAATAGATTCATGGATGACTGATCCT	73	ATM
CGAAATCTCCCTCCAAAAGTGGT	GCAATCGAACGACTCTCAAAACT	86	APC
GCATTCAGATTCCAAACAAGGAAAATATTTG	GTTAAGACTTACACACAAAAGTAATATCACAAC	75	ATM
GCAGTGGAATGGTAAGTGGCAT	AGGTACTTCTCGCTTGGTTTGAG	85	APC
GATACGAGATCGTGCTGTTCCA	TGAGAAATCTCCAAGGATCTGGTATCT	89	ATM
GCTGAAAAGAGAGAGAGTGGACCTA	TGGATGAACAAGAAAATCCATCTGGA	84	APC
AATCATGTTTATACTTTTATTAGGTGGACCACA	TCGGAACCTACACAATCTATTATTTTTGGTAAA	69	ATM
GAGGTGCACCATAAGCAGGA	GGGTAGGTAAAAGCAAGCCCT	93	PTPN11
GCCATATGTGAGCAAGCAGC	CTCGAAGAACAAAGGCCCAAGCTC	94	ATM
TGGTCCAGACAGAAGCACAGTA	CTAGCAAGAGAATGAGAATCCGCAT	86	PTPN11
AAAAATGCTTTGCACTGACTCTGA	GCACCATTCAAGAACACCACTTC	88	ATM
GAAATGTCATCTGACTCAGCTGGTAT	TCTGGTTTTTCTCCCTCATCCTCT	80	JAK3
TGCTCATAAAAGATACAGGCCAAATGA	CAGCTGTCAGCTTTAATAAGCCATTAAAT	70	ATM
GATACAGCAGGAAGTGAGGGTC	CAGGAACCTTCCTTCTGGTTGG	80	JAK3
AAAGATTCAGGCAATGTTTGTTAGTATTAGT	TGCAATTAAATTTGGCGGTGTCA	78	PTEN
GATCTTCAAATGTAAGCACATTCAAGTCC	TAAGGCAACTTCTTAGAGTTTTGGCAA	68	FLT3
AATGTTTAACATAGGTGACAGATTTTCTTTTT	GAATGTATTTACCCAAAAGTGAAACATTTTGT	71	PTEN
GGGAGACTTGTCTGAACACTTCT	CAGTGAGCTTATTTCACACGTTCTTTTC	88	FLT3
CTCAGAAAAAGTAGAAAATGGAAGTCTATGTG	CTTTGTCTTTATTTGCTTTGTCAAGATCATTTT	74	PTEN
AATATTGTGTAATTGGTAGCTTCACTCTGA	AATAACTAGTTCTCTTTCCTGTTTTGCAGA	64	FLT3
ATGCAACATTTCTAAAGTTACCTACTTGT	TGATAAGTTCTAGCTGTGGTGGGTTA	80	PTEN
GGGAATTCCTGATGGTGGAATATCA	GAGTGAAGCCATAAAAGGGTTCCT	82	FLT3
AGATCTTGACCAATGGCTAAGTGAAG	CTAGGGCCTCTTGTGCCTTTAA	91	PTEN
ACACCCACTGTCCAAACACTTTT	AGAAATCCTAACTTCCAATCTGATGACAG	84	FLT3
CGACCCAGTTACCATAGCAATTTAGT	AACAGGTAGCTATAATAATACACATAGCGC	83	PTEN
ATTATGCTAAAAATGGTATCTTAGAGTCCTTT	CTGTCAGGTTTAAAGCCTACCCA	83	FLT3
TCAAATGTTAGCTCATTTTTGTTAATGGTGG	GCAAGCATACAAATAAGAAAACATACTTACAGA	68	PTEN
TGATGTCAACTACATTAGAAAAAGGCCA	GGTCTGCATATCTGAGAGCGTT	89	FLT3
TAGTTTAAGATGAGTCATATTTGTGGGTTTTCA	CACTAACATCTGGTGTTACAGAAGTTGAA	76	PTEN
TCTAAAGTAAGGTCTTCTTAATGTGTAAAGC	TTTCATAATGACATAGAATCCTTTTCTGAGGG	63	FLT3
TTCTCAGCATACTTAAATGTCAAGAAATACA	AGCCATAGCTTCATCTTCAATACTTCC	79	APC
ATAACGACACAACACAAAATAGCCGT	CCACGGGAAAGTGGTGAAGATA	89	FLT3
AGGAATCAACCCTCAAAAGCGT	TCTGGCTCCGGTAAGTAAGAGT	90	APC
CAACCTGGATTGAGACTCCTGT	ATCTTTAAAATGCACGTACTCACCATTTG	73	FLT3
GGCAGAATGAAGGTCAAGGAGT	AGAACCATCTTGCTTCATACTTTTCTGAT	78	APC
CGTTCTCTAGAGAAAAACAGCTAAAGGT	CAAATCAAGATCTGCCTGTGATCAAG	83	FLT3
GGCTACGCTATGCTCTATGAAAGG	CCCTGCCTCAAAGAAAAAGAGAAAAA	83	APC
GCAGCTGCCCAACTTACCA	CGTCTGCCTGTAAAATGGATGG	84	FLT3
ACTTTTTAAAGTAAATGATTTGTGGATAAACCT	GGTTTCAGAAGTTCAAGAACATCTTCCAT	73	ATM
GGGAATCCTGCACCCACTAAAA	CCCTTCTGCGACTTTCCAGAAA	86	JAK3
TGCCATATTCTTTCCGTCTATTTAAAAGGA	TCTTACCTGACGGAAGTGCAATG	80	ATM
TGGATCACATCTCTACCAGAGTTAATCA	CCACGAACTGGCCAAGAGTTAC	81	NRAS
CCCTCCAATAGCTTGCTTTTCAC	ACTTCACACATATTTTGCTCTATTCCCA	84	ATM
AACTGTCCTTGTTGGCAAATCAC	CCAGCCTAATCTTGTTTTTCTTATGTTCTG	82	NRAS
GCTCTTATTCTATCAGTTAGAGGGTGACTT	GGAGAGAGCCTGATAAAACAAACAAAAA	66	ATM
TACAGAATATGGGTAAAGATGATCCGACA	GAAAAGCGCACTGACAATCCAG	88	NRAS
TTTTATGTATGATCTCTTACCTATGACTCTACT	AAGATGCATCTTTACTATGTTGTATAGCTATGG	69	ATM
CTCACCTTGTTACATCACCACACA	TCCTTTTATAGGGTGTTGAAGATGCTTTTT	85	NRAS
ATTTGAAGATAAAGAACTTCAGTGGACCTT	TGTGAAGTATCATTCTCCATGAATGTCAT	77	ATM
GGCAAATACACAGAGGAAGCCTT	AAAACAAGTGGTTATAGATGGTGAAACCT	74	NRAS
ACAAAGTAGCTGAACGTGTCTTAATGA	GAAAAGTCGGCTGAGATTTTTGGG	88	ATM
AAAGAAGTAATGCTGATCCAGGCTT	TGACCCTCTTTTCGGCTGTAGA	84	PTPN11
CACCACCAAAAAGATAAAGAAGAACTTTCA	GACTGGTGCTTTTCTATACCACATTCT	67	ATM
CTCTCCATTGGATTTAGGAAAGCTTAGA	GCCAGGTCCGAAAGTGGTATT	90	PTPN11
GAATCACTGGATCGCTGTCTTCT	CCTTCCTAACAGTTTACCAAAGTTGAATCA	74	ATM
GCAGTGAACATGAGAGTGCTTGA	CAAGATCTGTCAAAGAATCAAACCGTT	85	PTPN11
AGGTTTCTGAAATGTGTATAGCTTGTCA	TTTCAGGGTTCTCAGCACTATGG	88	ATM
TAAGAAGAATCCTATGGTGGAAACATTGG	TCTACCTCTGTATGTTTGCAAAATTCTCT	78	PTPN11
GAAAATCTGTTTTACTGACGTTGATAGCTG	CCATATATACCTTTTTCACAAGGTGAGGTT	77	ATM
TTTGTATTTTAAATCCTTCCTCATGTCCTGA	GCAATGTAACTCTTTTTGGGCTTTGAA	70	PTPN11
CTCACTATGAAAAACTGTAAAGCTGCAAT	CAGCTACTACCCAGCTAAAATTATCATCTT	78	ATM
CTGCAAAACACGGTGAATGACT	ACAGTTTAGCAGAAAAGAAGTTTCTGTGA	75	PTPN11
CCCACAGGTGGAAATGGTGTATT	CCAGACTGTCGCATGGATATACAG	78	APC
AATCAAATTCTCGGCAATTTAACTTACTTC	CCAAGTTTTGCAATCATAAGCACCA	70	FLT3
TCTTCCTCTCCTCATCCAGCTTTTA	TGTGAGTGAATGATGTTGTGGAGT	76	APC
TTACTAGATATGATACTCAAAAGCTTACCTCCA	TTTTTAGGTGTGGAATATCAAACAAATGATT	72	BRAF
GCGCTTACTGTGAAACCTGTTG	AATTTCACATTTGCTTTGAAACATGCAC	75	APC
TCTAACGATAGGTTTTTGTGGTGACTT	TGGATACCGTTACATCTTCTTCCTCT	71	BRAF
GGAAGTGTGAAAGCATTGATGGAAT	GGTAAGAAATTAGGAAATCTCATGGCTAAA	84	APC
TGGGATTAGACCTCTCATCATCAGT	AAAAATGTAATTTGCTCCCTTTACCTCTTATC	67	BRAF
AGGATGGCTGCAGCTTCATATG	TTCATATTAGATGCCTCAGTTTCCAGTTT	85	APC
AAAAATGTAAAGATACATACAAAGTTGTGTGT	AGAGAGAAGAAACCAATTGGTTGGG	67	BRAF
GGGCAGTTAGCATGCTCAAGAA	GGAGACATAATATTGGCATCCTTGTACTTC	77	APC
TTTTTAGTTCTAGCAATGCTGGATACT	CAGATGAAGATCATCGAAATCAATTTGGG	68	BRAF
TTGCCATCTCTTCATGTTAGGAAACA	AGACTTTGCTTGTGTCTCTGCTT	90	APC
GAGTAAATCTGTAAAGCTAATAGTTGCTACCA	CTCAGCAGTTACAAGCCTTCAAAAAT	81	BRAF
TCTCTATGGTGATTATGTTTTTGACACCAA	GAAGAGGAGCTGGGTAACACTG	73	APC
ATCCAAAAGAATAGCAGCCAAAACCT	TTTGAGATGATCAAACTTATAGATATTGCACGA	80	BRAF
AGGAAGCTTAGATAGTTCTCGTTCTGAA	TCTGCAAACCTCGCTTTGAAGA	74	APC
TGTGATCCAAGCTGTCCCAATG	CACCTAAGCAAGTGAAGGAAGAGAG	78	EGFR
CCCAGATTGCCAAAGTCATGGA	GGCAGCAGAGCTTCTTCTAAGT	86	APC
TGAGGCTACATTAATAACCATAAAGCATGA	CCCTTTCTGCTTCTTGAGTAACACTTAC	66	PIK3CA
TCAAACACTTACAATTTCACTAAGTCGGAA	TTACCATAACCATCACTACTACTGACACT	71	APC
TTGGGAGGATGCCCAATTTGAT	GTTTCTCCATTCATATATGGTGTAGCTGT	78	PIK3CA
CAGCCGACCTAGCCCATAAAAT	TTCATTCTGTGAAGGACTTTGCCT	93	APC
GCACGTCAGAAAAGGAAGATTAGG	AGTTCTTCTCAGTCAAGCTGCAT	80	FBXW7
CTGGAGTTGGATGAATTAGCCCT	CAGAGGGAACAAAGTCGGAATACC	92	ATM
GAGGAAAGGGCACGAATATACAAATATTAAGTA	CCAGGTAAAAAGAATTTCCTTCAGCACTA	76	PTPN11
AAGGAAGCCAGAATACAACTATTTCTAGC	AACCCAAAGTATGAGATAAATACTGTCATAAAT	62	ATM
CCCTTAACACGACTCGTATAAATGC	TTTTAATAACTTACCTCAAATTCTTCCCAAAAG	68	PTPN11
AAATCCTTTTTCTGTATGGGATTATGGAATAT	TCAGATAGAGCCTGAAGTACACAGAG	81	ATM
CATGGACATCTCTCTGGGAAAGAAG	ATCACCAGTGCGCACAGAAAGAAC	76	PTPN11
TTTTTCATTTTTCTTAACACATTGACTTTTTGG	TCCAAAACCAGATAATCTAAATGAGATGCC	61	ATM
TCCTGAAGCAGTCCAGGACTTA	GCTTACCATGATGATATTTGCATTGATGT	83	PTPN11
ACATTCCATTCAAGATAGAGAAAACACTGT	TTAACAATCGCAGGAAAAAGCCAGAT	80	ATM
AGCATTGTCTCTGAGTCCACTAAAAG	ACCATCTGGATGGTTTTGGGAAC	87	PTPN11
TCAAAGCTAATGAATGACATTGCAGATATTTG	TGTTGTGAGATGCATCCTTATTTACAAAGATAT	72	ATM
TTCTTTTTCTTTTCTCTCCAGAATGAGAGA	GCATTTAAATACCTATTTCTGTGCTGAAGT	74	PTPN11
CTTACAGCTAATCTCTAGAATTTCAATGGATCA	GCACATTTTTAGTTATTCTGCTTCTTCTGG	76	ATM
ACTGGTGATTACTATGACCTGTATGGA	GATATTTAAGCTCAATGACATCTCCATTCTTC	67	PTPN11
CCATATGTCATTTTCATTTCAGCTCCCT	GGGCAAGACTCTGCTCCTTTTT	89	ATM
GTCTTAGCTGTGTTGTTGTGGAAA	CAACTCCTCTTGTCAACAGTAGGTTTT	88	PTPN11
AAGCAGTCACTACCATTGTATTCTATATCAAC	AAATCCAGCCAGAAAGCATCATTAAAA	80	ATM
TTTTTGGCAAGGCCTAGTAAAAGT	CTATCCAAGCATGGTTTTACCACTTC	75	PTPN11
CAGCTTTACTCTATGCAGAAATCTATGCA	ATATACCCTTATTGAGACAATGCCAACATT	65	ATM
CCCAGCTGTGAGATGTACTTGA	CCAGACTATGAGCTCCTCTCAGA	94	JAK3
CTGGAATATGCTTTGGAAAGTAGGGT	CAAAGGAAGTGCTTTCAGTAACCTG	85	ATM
GGCCGAAGTCAGCGATCT	GATCCTCTCTGCACGCTCA	100	JAK3
AAATTGGTTGTGTTTTCTTGAAGGCA	TCTTTGGTATTGAGTATCTGAAAACCGG	79	ATM
TCTGCGAGGAATAGAGAAGGAGG	GACAGATCCTGCCTTCTCCAG	93	JAK3
GCAAGACCCAAACACATAATAGAAGATGAA	GTCCAAAATGTGGTTGGAACTTGA	81	APC
CGCGGACATTGACGTCCAT	CTGACCTGGACGACCAGACAGA	96	NOTCH1
AGCAGGAATGTGTTTCTCCATACAG	CTTCATAGTCATCTTCTTGACACAAAGACT	70	APC
ATGGATGGCCAACACCAGCC	ATCGACGAGTGCCTCTCCC	94	NOTCH1
GCATGAAGAAGAAGAGAGACCAACAAATTA	ACTGTTTCTGTGATGAAGGAATATCTGTG	65	APC
GATCTCCTCAGAGCAGTTCACC	GCTCATGTGGCCCTGTCAG	97	NOTCH1
CAGTGAGAATACGTCCACACCTT	TTGTTTCTTGGTTAATAGAAGAAACTTTGC	80	APC
CGTGGACCTCTCCAGGTGT	CAAGCCCTGCAAGAATGGG	98	NOTCH1
TGAGCCTCGATGAGCCATTTATAC	TTTTTCTGCCTCTTTCTCTTGGTTTT	89	APC
AGGCAGGTGAACGAGTTGATG	GTGCTGGCGAGGCAGAAT	94	NOTCH1
GTGGCAAGGAAACCAAGTCAGCT	GTGTCCCTTCAACACAATACACC	83	APC
CTGCGCACCAGGTTGTAC	GGTGCTGCTGGACCACTTT	91	NOTCH1
TGGTAAGAAAAAGAAACCAACTTCACCA	TGTCTGAGAAAACTCTCTCAGCATTTAAAT	66	APC
CTCGGACCAGTCGGAGACGT	ACAGCTACTCCTCGCCTGT	100	NOTCH1
CTCAGACAACAAAGATTCAAAGAAACAGAA	TTCCTTCAATAGGCGTGTAATGATGA	83	APC
GGGTGGTAAATTATAAAGTTGCTATGGATG	AGGGAAGGAGTGGTACAACAGATT	76	MET
TTTCCAGGGAAAAGGCTGAATTAAGA	TATTGGCTGCTTTGCAATAGCTTG	83	APC
TGGGAGCCAAAGTCCTTTCATC	ATCTTTCGTTTCCTTTAGCCTTCTCA	85	MET
GTTCTCTCAGTGACATTGACCAAGA	TGAAATGATTTAGGAGCATAGCCTGATG	76	APC
TGGGATGGTGCTTTGCTGATTA	GGGTTCAGAGGCTGATTGTGAT	85	EGFR
CCCAGTTTGTTTCTCAAGAAACAGT	CACCCTTGAGTCTTGAAGGCTTT	76	APC
CCGAGTATCTCAACACTGTCCA	GAAAGAAGTCCTGCTGGTAGTCA	80	EGFR
TAGTCCCAGAAATATGGGTGGCATA	CCTTCCTGAATAGCTTTCCAATCAAAATTT	76	APC
ATTTGGAATTTTGAAGAGGTGATTTGTGTT	CACTCTGGGTGGCACTGTATG	85	EGFR
ACAAGCAAGCTCTCCTGAAAAGA	ACTCACTCAGTTAACTGGTGAACATAAAAT	73	ATM
CCACCTGATTGCATGCCAG	GCAAGGATTTGGCCAGTGCTAT	95	JAK3
ACTTGCTTAGATGTGAGAATATTTGAAATACCT	AGCCAATTGGTACATAAGAGGCAAAA	65	ATM
GACTGGGAAACTGAGGCTAGC	CTGCGGATGATGGGATGTGA	98	JAK3
TGGGAGGCCTAGGATTTCATGA	TTTGTATTTCCATTTCTTAGAGGGAATGGTATA	84	ATM
CCATGCTAAAGAGGGACGCA	CGAGCTCTTCACCTACTGCG	99	JAK3
TCAGAGTAATTTTCCAGAACTTACTGGTTG	CAAACCTGACTTAATAAGTCACAACAAAGG	66	ATM
GAACACCCTGAAAGCTTGCA	CGGGAGAGCTGCTGAAGAC	100	JAK3
TTGCCAGACAGCCGTGACT	TACCATTTTGAAGATGAGTCAGAAAATTACCT	87	ATM
CCAAAGGAGAAAGATAGGCGCTG	CTCCAAGTGAAGAGACGCCC	86	JAK3
ACTCATTTTGTGTAGGAAAGGTACAATGA	AGATTTATATCATCCAGGCCTTCAAAAGG	76	ATM
CCCTAGCAGTAGACCGACCT	GACTTTGCCATCAACAAGCTCA	83	JAK3
TTGGACAGTGGAGGCACAAAAT	GTATCACAGCACTCTTTAGATAAACAGGT	74	ATM
GAGCACTCACCAGATAGTTGAGG	ATGGTGCAGGAATTTGTACACCT	86	JAK3
GATGACCTGAGACAAGATGCTGT	GGTGAACTAACAGAAGTACAAATAGTTACCTTA	83	ATM
CCAGGTCCATGATGTACTTGGC	AAGCCTGCGCGACCTGATC	98	JAK3
CTGGCTTATTTGTATGATACTGGTTCTACT	TTTCAAAGGATTCATGGTCCAGTCA	84	ATM
GTGGGAAGAACAGCCTAGACTT	GGAAGCAGCGAGCTTGATG	98	JAK3
GCCGGAAGATGAAACTGAGCTT	CCTTGGGAATAAGAAAATCTGAAAAACTGA	75	ATM
GCAGCACCTCTGTCTTTCGG	CTCACTGGCCTCTTCTGCTG	89	JAK3
CTGGAATTTGCATTTTTCCTTCTATTCACA	GCATCATATTTCTCAAGGAACCAATTCTGA	64	ATM
GGGCACTTCCTACCGAATCC	GCATCCTGCCTGTGTACCA	97	JAK3
AGGTATTGGACTTGTTGAAATACTTAGTGA	GCTGAGTAATACGCAAATCCTTAAAAACAA	65	ATM
CCCAATATGACATCACAGCCCT	CTGCTGATTCAACAGTGCATGG	95	JAK3
GGAAGGTGCAAATTCCATAGTAAGTAGTTT	GTGATCCCAGAGAGATTCCTGATTTC	68	APC
ACCAATGCCTTCTTTAAGCAATGC	AGAATTCGATGATCAACTCACGGAA	90	EGFR
ACCATTTCATCTTACACCTGATCAAGAAG	TTTTTCCTCCTTTGATTCCTTTACTTTCAG	80	APC
AACATAACATCCTTGGGATTACGCT	CCGGAGGTCCCAAACAGTTTTT	77	EGFR
AAACAGCCACCACTTCTCCTAG	GTCGAATCTCTAGATCCTGATCTAGAAGG	78	APC
AAAGACTCACTCTCCATAAATGCTACG	TTCTTTATACAAGCAACTGAACCTGTGA	75	EGFR
CCTATACAGTCTCCTGGCCGAAA	GAACCTGAGGACTTAGTTGAAGCA	77	APC
GGATCCAAGCCATATGACGGAAT	CCACCAGTCACTCACACTTGAC	87	EGFR
CAGAACCTTACCAAACAAACAGGTTTATC	AGAAAGTTCTACCTTTTTATTGGCTCCAT	67	APC
GGGCCATTCTAATAGCCTCAAAA	AGGTACTCGTCGGCATCCA	96	EGFR
TTCAACTAAATCAAGTGGAAGTGAATCTGA	GAGAAAGAGATTCAAATGAAGCAGATTCC	80	APC
TTCCTTGTTCCTCCACCTCATTC	GTGCGCTTCCGAACGATG	98	EGFR
CATCTAGACCAGCTTCTCCCACTA	ATTAGGTGGGAGTTTTCGCCAT	81	APC
ATGCCAAAGAAGTAGAATGAGAAAAATGTATA	CATTCTTGACGAGGTCCATGTGA	80	EGFR
CCCACTATAGAGTATAATGATGGAAGACCA	AATGTTTGCTGTGCTCACGTTT	74	APC
GTTATGTCCTCATTGCCCTCAACA	CTTCAGTCCGGTTTTATTTGCATCAT	89	EGFR
TCGAGTAAGCACTTGGAGAAGAAC	CTTGGTTTTCTTTACTTTGTTTGGTTCCT	86	APC
CCTGGACCTTGAGGGATTGTTT	GAGAAAATGATCTTCAAAAGTGCCCAA	89	EGFR
CGCAAAAGGAACATGGAGAAAAATAAAAG	TTTTAGAAACAGCAGGTGCCATTTG	85	APC
GTTCAATAACTGTGAGGTGGTCCTT	CCTTTCTCCACTTAGATTTTCTCCAATTTT	82	EGFR
ATTGAGGACTGTCCCATTAACAATCC	CCACATTTTGTTTTGCCTGATTATCTTTTG	82	APC
CCCAGGCCTCTCACATATTGAA	GGACACGCTGCCATCATTACTT	86	EGFR
GTACCGTGGGTTTGGAAAATCG	GGTACGTTCCACTATAGAACTTTCATTAGT	87	APC
AGTCATGCTTAGGATGGATCCCT	TGAAGGCATGAGGCTCAGTG	95	EGFR
ATCTCAAGGAGATCTCGGGTGAT	TGAGCTGTATCGCTGCAAGAAG	92	EGFR
AGCCACTCGCATTGACCATT	CTTTGAGACTGGCCCACCTC	97	NOTCH1
CCAAGGTGCCTATCAAGTGGAT	GCTTGGCCTCAGTACAAACTCATTAG	77	EGFR
CACCTTGGCGGTCTCGTA	CCTCTGGTGATGGAACCTTGG	95	NOTCH1
GCTCACCGCAGTTCCATTCTC	GACATGTTGCTGAGAAAGTCACTG	87	EGFR
GCAGACTCCCGGTGAGGAT	GTGTCTGAGGCCAGCAAGAA	99	NOTCH1
AAGAAAGAGACATGCATGAACATTTTTCTC	GGGTGTTGTTTTCTCCCATGACT	83	EGFR
TGGCACACTCGTCTGTGTT	CGTTTCTGTCCCAAGTCCACA	86	NOTCH1
CAACACCCTGGTCTGGAAGTAC	TCTCTGAATTTGCAAGAGAGGAAATGTT	74	EGFR
GGGTTGCTGTTGCACTCATT	ACATCGATGAGTGTGCGGG	99	NOTCH1
TGACCAAAATCATCTGTGCCCA	GGGCATCTTACCAGGCAGT	88	EGFR
ACACTTACTCTGCACGGCC	GATTGACAACCGGCAGTGTG	99	NOTCH1
CTCTGTCACTGACTGCTGTGA	GCTGACATTCCGGCAAGAGA	89	EGFR
TACTGGGTGTGGGTCTGCCAG	TGCGTTCTGAGCTACCGGG	96	NOTCH1
AAGACGGCGTCCGCAAGTG	GGAAGATGTGTTCCTTTGGAGGTG	91	EGFR
ATGTGTATCTCTAATAGCTAAAATTCACTTCCT	CAATTTTCAATTTAACAGCAAACTCAGTTGAA	61	MET
GGCTTTCTGACGGGAGTCAA	CGTGGCTTCGTCTCGGAATT	87	EGFR
ATGTTGTCCTTGTAGGTTTTCCCAAATA	CTCATTTCCAAGGAGAACTCTAGTTTTCTT	79	MET
CCCACTCATGCTCTACAACCC	GATGCCTGACCAGTTAGAGGG	92	EGFR
AATGAGAGCTGCACCTTGACTT	GAGATGAGCTTCTTGAGCAATTTTAAAAGA	87	MET
CCATGCCTTTGAGAACCTAGAAATCA	GCAACTCTCCTGTTAAGCCTAATTTCC	71	EGFR
GCAGGTGATTAAATTGAATCCCTCTCT	GGGACACTAACTGAATTCAGGTTTTTC	85	MET
GTGTCCCTGGAGTCCAACG	CGAGACAGCTCCCATTTGGG	100	FGFR3
CCCTGAAAACCAAAGCCTTTTTCA	TCCAGTACATTTTCATTGCCCATTGA	85	MET
GATCATGATAAAACTCTTCAGACTGATTCT	AAATGATATCTAAAGGTCACTAAGCTAAAGACT	76	RB1
CACGAAGACTGGTGCCATGA	AGTTCATGTGTAAGGTGTACAGTGAC	93	FGFR1
GAAGTACATCTCAGAATCTTGATTCTGGA	AGTTGCCTTCTGCTTTGATAAAACTTTC	68	RB1
CGTAGCAGTGACGAATGTGGT	CAAAGTCCTCGGACACTTCCA	97	CDH1
AGAGAACACCACGAAAAAGTAACCTT	TGAACAAATCTGAAACACTATAAAGCCATG	83	RB1
CCCAGGAGCCAGACACATTTAT	GACAAATGACAAAATGCCATGAAGTACATA	86	CDH1
TGGAAGTGTTTCCACATTTTTATGAACAATT	TCTTTTGGATTCACTGTGCAGTTCT	83	RB1
TGTCTGGCTAGGTTGGACTGTTA	GGAGTTGGGAAATGTGAGCAATTCT	80	CDH1
ATTACCGAGTAATGGAATCCATGCTTAAA	TGATGCCTTGACCTCCTGATCT	88	RB1
ACAGAAGAGAGACTGGGTTATTCCTC	GGTACTTCTCTGCCAAATCCCT	82	CDH1
GCATGCGCTTGACATCAGTTTG	GTGATTACCAAGGTAACTCAGGACTT	85	KIT
GGTGTGCCCTTCCTTTCACTAA	CGCTTCCTTCATAGTCAAACACGA	78	CDH1
ACACCTTCACAATATACCCTCCATGA	GAATTGTTGCTGGTTGCACTCT	77	EGFR
CAAAGACCAGGACTATGACTACTTGAAC	GATTTCTGCATTTCCCAGCACAT	88	CDH1
GTTTTTGGAGAAGCACAAGCATATAGAC	TTTTTGTAGATTCTCGCCTCTATTGAG	84	BRAF
TTCTTTCCTACTCTTCATTGTACTTCAACC	ACTCATGAGGGTTGGTGCAA	77	CDH1
ACTTATTTTCTACAACTGGAGCCTTGT	GTTCTGTATGAATTGATGACTGGACAGTTA	72	BRAF
CTCTGTGATAGCTGCTGCTTCT	GCAGTAAGGGCTCTTTGACCA	95	CDH1
GCATATACATCTGACTGAAAGCTGTATGG	AGTAGGTTGTTTTTCAGTCTTTATTCAATTGAA	65	BRAF
ACCACAAATCCAGTGAACAACGA	CAAAGCGAATCTACTTCTAAGAAGATACCA	86	CDH1
CAGAGCTAGAAACAGAAAAATCAGTTCC	AAGTCCGGATTGAATATAAGTCTGCTTTATTT	79	BRAF
TCTTCAGATCAAATCCAACAAAGACAAAGA	TATCCAGAGGCTCTGTCACCTT	87	CDH1
GATCCAAAAGAAAGCGGTTCAAGT	CACAGGAAGAGGCGTCCTTA	92	BRAF
GCGGGTGTCTTTAGTTCACTAGC	CCCACCTCTAAGGCCATCTTTG	94	CDH1
GCTGAGAGTGGGCGAGTTT	CGGTCCTTGTCAATGCCG	95	FGFR3
CGCCGTGATGAATATCGAACAGA	GCTATGGTGAGGTCTCCTTTAATGAAG	74	MET
CTCTGGGAGATCTTCACGCTG	GATGCCACTCACAGGTCGT	90	FGFR3
CCCACCCTTTGTTCAGTGTG	GCCAGCTGTTAGAGATTCCTACC	84	MET
GACGGCACACCCTACGTT	TAGACCCAAATCCTCACGCAAC	85	FGFR3
CCCTCCAGGATCCTGTAATAACA	GTTTTTCCACCAATTGAAATGTGTCTAGAA	76	MET
CCGCAGTCCTGGATCAGT	GCTCAGCCAAAAGGCCTTCT	99	FGFR3
ACTGAGCTTGTTGGAATAAGGATGTT	CAATCACTTCTGGAGACACTGGAT	77	MET
GCTGGTGACCGAGGACAAC	GCGTCCTACTGGCATGACC	101	FGFR3
CTTTTACAGAAATGCCTGCCTTCAA	GGACACCAGTTCAGAAAAGGATGG	81	MET
AAGATGCTGAAAGGTGAGGAGG	CATCTCAGACACCAGGTCCG	96	FGFR3
TAGTTCAACCAGATCAGAATTTCACAGG	ACAGTAACAAAAATGCACCTTTAATTTGCT	76	MET
CGAGTCTACACTCACCAGAGTG	GTAGAAACCACACCCAGGAGCTCC	93	FGFR3
TACATGAGCATCACATTTTCCTTGGT	ACATGGGAAACAATCTGGGTGTT	75	MET
CGGCGTTTTCCTTGCAGC	CCTCTAGCTCCTTGTCGGTG	99	FGFR3
GGAAAGATAACATCAACATGGCTCTAGTT	ACTGTATGTCAGCAGTATGATTGTGG	76	MET
GGGCAATTCTATTGGGTTTTCTCAT	ATTCCCGTCCGTCCTGGCA	95	FGFR3
CGAAAGATGGTTTTATGTTTTTGACGGA	CCCTTTGGACCGTCAAGAAGTAAATAAA	78	MET
CTTCCTGTTCATCCTGGTGGT	CCTGGTATCTACTTTCTGTTACCTGTC	91	FGFR3
AGATGCTCAGACTTTTCACACAAGAA	ATTAAACACTTCCTTCTTTGTGGATCTCTT	82	MET
CCAGGAAGTGCTGCCCAAAT	CGTCTTCGTCATCTCCCGA	95	FGFR3
AATAGGAGCCAGCCTGAATGATG	TGAAGAAGTCGTTGACATATTTGATAGGG	75	MET
TTTCTCAAGTTGGCCTGAATCACT	CTCCAATTCCCAAAATGAAGGTAGCTA	88	PIK3CA
ACAATGTGAGATGTCTCCAGCATT	CCCTGGATATTCTTTTTGAGACTGATACTT	85	MET
CTCACAGACTTTTAGACATCGTAGCT	GCGTTGTAGTACAGAAGTTCCACT	89	BRAF
CAAAATCAATCTCAAGCTCATGGATAACC	GAATTTGCAATCCTGCTTCGACA	81	CDH1
TATAACCACATGTTTGACAGCGGAAA	TTCTTGTGAGTTTTTGAAATCTCTGTGATTTTT	71	BRAF
ATTTTTCCCTCGACACCCGATT	ACTTTGGTGGAAAACTTTCTGTAGGT	90	CDH1
ATTACATTTGGCTGTGACTTCTAAGAAGAA	CTCCAGGACCTCAGCGAGAAAG	72	BRAF
CCCGTTCAGATATCGGATTTGGA	CTGTGTACGTGCTGTTCTTCAC	85	CDH1
TGTAAGGCTTTCACGTTAGTTAGTGAG	CCTGATAAATTAACATACTTGCTCCTCCTT	76	BRAF
GGACGATGATGTGAACACCTACAA	AGTGGTGACCACACTGATGAC	81	CDH1
AAATTTGGTCTCAATGATATGGAGATGGT	AAACACGACATGTGAATATCCTACTCTTC	66	BRAF
CGCCGAGAGCTACACGTTC	TGTGGGAGTGCAATTTCTCGG	99	CDH1
AAAAACCTGAAATCACTACTTACCTCCA	GTGTTATCGCTACTCTCTGATTATATGCTT	66	BRAF
CCAAGCTGCCACATTTTCTGTG	CAGAAGAATATAGTTCGAGGTTCTGGTATG	79	CDH1
GTCTGTTCTTTTGGATAGCATGAAGC	CCAGATCTCAGTAAGGTACGGAGTA	86	BRAF
AAGCCTCAGGTCATAAACATCATTGAT	GCCAAAATAAAACTCAGGTACCCACTT	85	CDH1
ACCTTTTGGAAATTCATTTCTTTTTCAGGG	TACTCACTTTTTCTATACTTGCTTGCATTTTTG	73	NPM1
CTCCCATGTTTTCTTCCTCATCAGA	GTCATTCTGATCGGTTACCGTGAT	89	CDH1
CGGTGTATTTCTCTACTTACCTGTAATAATGC	CCCAGAAAATCCAGTTACCTCTTG	82	NPM1
GAATTCACCCAGGAGGTCTTTAAGG	TTTGGGCTTGGACAACACTTTG	83	CDH1
GTTTCAGTGTTATTTTTCTCCTTGTTAGAGTTG	GTACCGTTCTTAAAGATAACTGGTGCT	75	NPM1
AGGGACCGGGAAGTCACTATT	AGCCACCATCTTGGTGACATG	89	SMO
AGCTTTTAGTTTGGTGATAGAACAGCT	TCATACTTACTCTTCATCATCATCCTCTTCA	77	NPM1
GACTGGGCAGAGTGACGAT	CGTCGTGGGACACAGTGT	99	SMO
AGTTAACTCTCTGGTGGTAGAATGAAAAATAG	GCCAGAGATCTTGAATAGCCTGG	84	NPM1
ACTTGGGACTCCAGAGCCTTA	GGGTGGTTGCTCTTGATGGA	96	SMO
TGTTTTAGCCTGTTAAAACATTTGCTATT	CCTCAATAAGTCCCACACAGTCA	74	PIK3CA
ACAGTTGGTCCTGCCATGAA	AAAAATCAAACATGATAGGATAGAATCTTCCT	75	MET
TGCGAAATTCTCACACTATTATGCAAATTC	TACAACTCACATTTCTCCTTTGTTCTTGT	65	PIK3CA
GCTGGTGGTCCTACCATACATG	ATTTTGAAGGGATGGCTGGCTTA	81	MET
TTTCTTTAGATCGGCCATGCAGAA	CCTTTGATTAGTCAATGCTTTCTTCAGTAAAAA	75	PIK3CA
TATATTCCTTTGCCATTGTTAGCATTCCT	CTCTTATTTCCAACTTTTAACACTTCACCT	76	MET
TTGGGCACTTTTTCTTTTGGCATT	CTCTTCCAGCCAAACATAAACAAAAGTAT	86	PIK3CA
AGAATATACACTTACATTCTGAAGCCGTTT	GGCTTCCTTATTTACATCATGAGAGGAATG	64	MET
TATGGAACTTCTGGACTGTAATTACCCA	ATTTTACCTGTACTAGCTGAATTAAATACTGAG	63	PIK3CA
CATAATTAAATGTTACGCAGTGCTAACCA	CAAGGATTTCACAGCACAGTGAATTTT	68	MET
GTCAACCTTTTGAACAGCATGCA	TGGGCTACTTCATCTCTAGAATTCCATT	87	PIK3CA
CTGTAGGCTGGATGAAAAATTCACAG	AGACTTTCCAAAGCCATCCACTT	88	MET
GTGGTGATCTGGGTAATAGTTTCTCC	AGAGGATAGCAACATACTTCGAGTTTTT	80	PIK3CA
TTCCATTATAAAAGCTCTTCCTGTTTCAGT	ATACTGCACTTGTCGGCATGA	83	MET
ATCCTCTGAACAACTAAAACTCTGTGTTT	ACTTGTTACTCACCTTATACTGACTCAGA	66	PIK3CA
TCCATTACTGCAAAATACTGTCCACATT	CTTCCTATGACTTCATTGAAATGCACAATC	67	MET
CCCAAATTTGCATCTGTGGCAT	CAAGACCTTGATTTTGCCAGATATTTTCC	73	PIK3CA
GGTCACATCTCTCACCTCATCTG	GCAACAAGTAAACAGTTATATCAAAGGTGT	84	MET
AGTTTTTAACTATTTTAAAGGCTTGAAGAGTG	GATGATCTCATTGTTCTGAAACAGTAACTCT	62	PIK3CA
TGTAAAAGATCTTATTGGCTTTGGTCTTCA	GGATTGTGGCACAGAGATTCTGATA	76	MET
CTCATGTGAGAAAGAGATTAGCAGTTAGT	AGAGCATCCATGAAATCTGGTCG	86	PIK3CA
TCCCTCTGGAATAACCAGCTGT	AAGCAAAGCGTTCTTTACGAACAG	93	GNAS
ACTTGCAAAGAATCAGAACAATGCC	AGCCTCACGGAGGCATTC	96	PIK3CA
TAGTATTCTATAACTCGGTCTTCATGCAGA	TGTTTTGGTGGACCCATTACATTAGATTT	65	RB1
TTCTAATTGCAGTCTATACGAGATACTCCA	GACCCACGTGTAAATGTAGCCA	73	NPM1
CTGACTGGCGGAACTCGAA	ATCTGCACGGCAGACGAT	96	SMO
TTTTTGTTCACAGGTCAGTTTAGGG	CCCTTACCGTTGGCTGTACA	94	NPM1
CGGGACTGGGCTTGGTAA	ACTCAGCCTGGTTGAAGAAGTC	86	SMO
AATGTCTAATAAATTGTATTTTAGCTGTGGAGG	CTACCTGTGGAACCTTGCTACC	79	NPM1
ATGAGCACCTGGGTCTGGACC	ACCCGACAAAACCTAAAGATGGG	93	SMO
CACATGTTTAGTGATGAAAAATTTCTCCCT	ACATACCTACTAAGTGCTGTCCACTAATAT	74	NPM1
TCAAGTGACACCTCACCTCTCT	GAAGGAAGTGTGCCAGGCATA	93	SMO
CATTTCATCTCCTTGCATCTCTACCA	ATTTCACTTTATAATGAAATAAATGACAAGGCA	65	IDH1
TGCCCAAGTGTGAGAATGACC	TTCAGGGAAGCGGTCAGGA	96	SMO
CCCATAAGCATGACGACCTATGA	CAAATGGCACCATACGAAATATTCTGG	74	IDH1
GCCAGTAACCCACCTTCTGT	GATGAGCACCAGGCCGATT	99	SMO
CCCTCTTCTCATCAGGAGTGATAGTG	GCTATGATTTAGGCATAGAGAATCGTGATG	69	IDH1
CACCAACCTGATGGACACAGAA	GAAGCATGCTCGGTGAGGAA	84	SMO
GTTAATTTGACCATAGAAACTAGGGCATCT	CTTGCCTTCTTTGCAAATGCTTT	86	IDH1
GGCTCGTGTTGTCTCTCCTC	GCACACCTCCTTCTTCCTCTTC	97	SMO
CTCTTTATTGTTATCAAGCTTTGCTCTGT	TGAGACATTTGGAAACCTCTATAACTAGGA	68	IDH1
CCCTGGTCTCCAACCCATT	TTGGTGCGGGAGTGAATAGG	90	SMO
CTTTCTGGTACATGCGGTAGTGA	CACTACTTACAGGGTATGGCTCTCT	77	IDH1
ACCCTGCCATGCTACCTAGATA	CTGGCCTGAACTGTTGAACTTG	84	SMO
CATACTCTATATGCAAATGTCAGCTTACTTGA	TGAGCACCAAAAACACTATTCTGAAGAAATA	76	IDH1
AGCTGGTACGAGGACGTGG	CTGACCAGGGTGAAGAGCGT	100	SMO
CTCAGATACAAAGGCCAACCCT	TCCTCTCACTGGCTTCTCCTC	91	IDH1
CTCACCTTGAGAACCTTGAGGTAG	GGTCGGAGGAGACGTAGAGT	93	FGFR2
ACTCCATGCTTAGAGTTGGAGTTTG	GTCCTGCGTGGGAATAGCTAAAT	81	PIK3CA
ACCCACAGATCCACTGTGC	CTTGTGGGCAAACTTGTGGTAG	85	RET
ATGTTTTGGTGTTCTTAATTTATTCAAGACATT	TTTTTCTTCTTGTGATCCAAAAAGTGTC	66	PIK3CA
CTCGTGCTATTTTTCCTCACAGC	GAATCCTCTTCATAAACATCTCGGGA	76	RET
GCAACCTACGTGAATGTAAATATTCGAG	TCTGAAAACATACTACAGGTCAACAGATTA	81	PIK3CA
GGATCTTCCTCATGCTGTTCAGG	AAGGTCAGACAGAATATATGATCTCATTAATGA	82	RB1
GGCATGCCAGTGTGTGAATTTG	GCTCTACTATGAGGTGAATTGAGGTC	76	PIK3CA
ATCTTTAAAGAGAAATTTGCTAAAGCTGTG	CGAACTGGAAAGATGCTGCTTTTAATATT	70	RB1
AGTAGAGCAATGTATGTCTATCCTCCA	ACAGGTAGAAGACTGCACTATAGTAATGAT	79	PIK3CA
CAGCACCATCACCACTTACCTT	GCATCTTTACAGCGACAGTCATG	94	KIT
GCACGATTCTTTTAGATCTGAGATGCA	AGCTTTTCCATTGCCTCGACTT	85	PIK3CA
CCCACAGAAACCCATGTATGAAGT	TCAGCCTGTTTCTGGGAAACTC	81	KIT
GATCTATGTTCGAACAGGTATCTACCATG	ACTGCTAAACACTAATATAACCTTTGGAAATAT	77	PIK3CA
GGCACGGTTGAATGTAAGGCT	GATATGGTAGACAGAGCCTAAACATCC	88	KIT
ACCTGATCATTATAGATATTCTGACACCACT	ATTTTCATGGTGTTTTATCCCTCTTGATAAAAA	67	PTEN
AGGGATTTCTCGCGTTGGAATT	TGCTGGTTTGTTCAACATATGTTGTTAAT	80	ERBB4
CTGCCATCTCTCTCCTCCTTTTTC	CAGGTCAAGTCTAAGTCGAATCCATC	74	PTEN
AGGGCATCTGGATCCCTGAT	TTCCTGTCCTCCTAGCAGGAG	97	ERBB2
AGCCAGCTTGCGATAACCAA	TCCATTTTGTTTCAGAAATGATCGGAAAC	79	CDKN2A
CTTGTTTTATTTTAGCGAAGAATAGCCAGA	CTATTTTTATACCCACAAACAAGAAAGGCA	78	APC
GCCTGGGCTAGAGACGAATTATC	TACTGAGGAGCCAGCGTCTA	96	CDKN2A
GATCCTGTTTGTGAATGACACCAAG	CCTCCACTGTTACAAGCAGCT	81	RET
CCTCAGTAGCATCAGCACGAG	TCTTGGTGACCCTCCGGAT	99	CDKN2A
GCCTGTGCAGTTCTTGTGC	ATGGCTTGTGTCAAGGGCT	93	RET
AGGCTCCACCTCTGTACCTT	GCATAGGCTCATCGACGACAT	85	IDH1
GCTTATCCATTCTGTGTCCTTCCT	CGTGCTTTCTCCTTTTGTTGCAG	91	FGFR2
ACCAAAAGACAATTATCCTTCTTAGCTCA	CCGTTAGTGTGCAACGTTCTGA	84	IDH1
CACAGAAGTCGATGGCATCAAAG	TGCACAAGCTGACCAAACGTAT	94	FGFR2
GGCATGCTATCCACAGGTGATT	TATGGCAGCATTGACGTCAGAAT	93	KIT
TGGCTTCTTGGTCGTGTTCTTC	TGGAAGAGAAAAGGAGATTACAGCTTC	83	FGFR2
GCTGGATGCCCATACATTTGAAAA	GAACAATTTGCTTGAATGTTGGTCTTTTT	86	KIT
GTGCAGGCTCCAAGAAGATTTATGATAT	TGAACTGATTTGTGAATATGCCTACTGTT	79	FGFR2
CCATCATGGAGGATGACGAGTT	CAAAACTCTTTAGAGAATCACTCCCACTT	77	KIT
AAAAATGTAATGGCTACAGAGAAGAGAG	CGGCCTCTATGCTTGTACTG	76	FGFR2
AGAGCATCTTCTTGAAGTTTCATTGGT	CGGAAGCCTTCCTTGATCATCTT	89	KIT
CCAATAAGCACTGTCCTATTGTTGG	CAAATCTCTCAACCAGAAGTGTACGT	88	FGFR2
ATCTCTCCCAGCAGCGATAGTA	TACTCTTGGTTGCTTGATAGGTAGGTA	85	KIT
AGCTGTGTTAATTTTATAGCAGTCAACCA	GCGGGTAATTCTATTGGGATATCCTTTC	67	FGFR2
CACCTTCTTTCTAACCTTTTCTTATGTGC	CTGCTTTGAACAAATAAATGAATCACGTTT	67	KIT
GAAATGTGATGTTCTGAAAGCTTAATTCT	AACACTGTCAAGTTTCGCTGC	88	FGFR2
GCAGGAAGATCATGCAGAAGCT	GCCTTGATTGCAAACCCTTATGAC	89	KIT
GCCCACTGTGTTACTGCCAT	CCAGAAATGTTTTGGTAACAGAAAACAATG	78	FGFR2
TGTGACCAGCCATTCCAACTAC	GGTCACTTCTGGGTCTGTGAGA	95	KIT
CTGGGACATGGCCAAGAGAAGT	GATAACAACACGCCTCTCTTCAAC	83	FGFR2
CCAAGGACTTGAGGTTTATTCCTGAC	AATTTTTCCGACAGCACTGACTTG	79	KIT
CCCAGCCAAGTAGAATGTGAAAGA	GAGTACTCCTATGACATTAACCGTGT	89	FGFR2
CGGATCCCATCGCAGCTA	CTTCGCCGAGTAGTCGCA	100	KIT
GGTATTCTCGGAGGTTGCCTTT	TAACTAAAAATGTTTTGCTGAATTGCCCAA	81	FGFR2
CTGAGACTTTGCATGGTTTCTTTCC	GCTGACTCAAGATTTGATAGTTAGACGATT	82	FBXW7
CTCCTCAGCTGAGATGACCTTC	GGACCCTCACCAGGATCTTG	97	RET
TTTCTACTTGTTTTCAGAATCACTCTGCT	CTGGAGAATTTTGGCTGAAGACAAC	73	FBXW7
ATGCAGAGACACAAGCAACCTCA	CCTAGTTTCAGAGTCCATGCTCTTG	76	RB1
AGCAGGTCTTTGGGTTCCAG	GTATCTCATCCTGTGGAGAATAATTAACTTATT	79	FBXW7
TCATCTTAACTTGACAGAATCTTAGTATCAATT	CTGCATTTGGAAATTCAAATTATAGAAAGCTTT	71	RB1
GGCCCAAATTCACCAATAATAGAGG	AGAGACTGGAGAATGTATACACACCT	82	FBXW7
GTGTTATCTGTTTCTTTCTCCTCTGAAGA	GCACTAGCCTTGGTGAAATCTAGG	85	FGFR1
AGTGTCCGATCTGTAGATCCACT	TCACTTTTCCTTTCTACCCAAAAGTAATCA	86	FBXW7
CCTGGCTCTTCCCACTAAACTC	CCTCTGACAAGGGCAACTACAC	86	FGFR1
GATTCATCAGGAGAGCATTTAAGGGA	GGAGCATATGATTTTATGGTAAAGGTGTG	83	FBXW7
GCACATCTCAGTTTCCCACTCA	AGTACTCCAGTGAGAAGACAGCA	79	FGFR1
CCCTCCTGCCATCATATTGAACA	GTTTCTCCCTCTGCAGAGTTGTTAG	89	FBXW7
CTCAGCTCTGCTAGCAGTCTTG	GGGCATCAGCATCAGTCACTTT	85	CDH1
CTCTTTAGGGAGCAATGAAATGAAGTCT	GACCAGAGAAATTGCTTGCTTTAGATG	69	FBXW7
GAAAGGAAAGCCTCACCTGTCT	CAGGTTGATCTTCTCCACCAGAA	93	SMO
CCTGTGACTGCTGACCAAACTTT	CACATCTTTCTTATAGGTGCTGAAAGGA	74	FBXW7
ATGGCGCAGAAGAGTCGACAAG	GATGGTGCGGAAGATTTTGTCAG	91	FGFR2
CCATTCCTGGAGGCCTGTAG	TTTTTGTAGTACCACTGGGCTTG	92	FBXW7
CCCAGCGTCCTCAAAAGTTACA	CCACAATCATTCCTGTGTCGTCTAG	81	FGFR2
TCTGTATGAGGTTGACTCTTTTTGTGATG	GGATATCAAAACAGGACAGTGTTTACAAAC	79	FBXW7
CATTGTTACCTTGCTGTTTTGGCA	GAAGTGCTGGCTCTGTTCAATG	83	FGFR2
TTGAGTTCCATTCCACTTGTTAACGA	GTTTGATGGTATCCATGTGGTGAGT	74	FBXW7
TCTAGGTGGAATGCAAGCTTTAGG	CCATGGCACCAGTTTACTCAGAA	89	CTNNB1
TCCTAGAGTAAGCCAGGGCTTT	TATAGAACTCTGAACCACTAGCTTTCCA	76	KIT
CGCATGGAAGAAATAGTTGAAGGTT	ACCTAGAACACTTCACTTAAAACATACCTG	82	CTNNB1
CAACACGATTCTGTTTTTCTTGGCA	CAGTGCATAACAGCCTAATCTCGT	87	KIT
TGTTCCGAATGTCTGAGGACAAG	GGAAACTACCAGATAAATAACTGCTCACAT	85	CTNNB1
CGGGCTTTGTCAAATGGACTTTT	GCTTAAGCCGTGTTTGTTGGTG	85	KIT
GATACCAATAGATTTAGTGTGGTGGGAAT	GGACAAAGGGCAAGATTTCGAATC	72	CTNNB1
CCACACCCTGTTCACTCCTTTG	AGCACTCTGGAGAGAGAACAAATAAATG	76	KIT
GGTGCCATTCCACGACTAGTTC	CTTTTAGATAGCCAGGTATCACTGTAAGAA	79	CTNNB1
CTTCTGTTCAATTTTGTTGAGCTTCTGA	CCAGACGTCACTTTCAAACGTGTA	86	KIT
TGGTGGTTAATAAGGCTGCAGTT	GCTGTTTCTACATCATTTGTATTCTGCAT	83	CTNNB1
CTGAGGTTTTCCAGCACTCTGA	TATTGTGGGCTCTGGGAATCCT	87	KIT
GGACCTTGCATAACCTTTCCCAT	ACTTTTTAGCTTCAAGCATTCTGACATG	73	CTNNB1
CATGATAAACACTACAGTATTTGTAAACGATG	CCATTTATCAGTGAAGGTTCTGTTCATATAGAT	61	KIT
AGCTTCTGGGTTCAGATGATATAAATGTG	CAGTACGCACAAGAGCCTCTAT	80	CTNNB1
GCATCACGGTGACTTCAATTATGAAC	TTGTTGTGACATTTGCTGATCCAAAA	72	KIT
GTGACAGGGAAGACATCACTGAG	GTGGGTGTAAGAGCTTAACCACAA	90	CTNNB1
ACAAAGTAAGCTGTACACATTTGAGGA	ATAGCTTGCTTTGGACACAGACA	89	KIT
GCTGCTATGTTCCCTGAGACAT	TTTACAACTGCATGTTTCAGCATCTG	79	CTNNB1
GAATTCACAGTGACGTGCACAA	TATCATCTCCCACAGAGACAGAACAT	77	KIT
TATCAAGATGATGCAGAACTTGCCA	CCTTGAGCATTTACTTCAAAGCAGACTA	71	CTNNB1
AAGTATGCCTTTTGTTGCTATGTTCG	TTGATCCGCACAGAATGGTCTAC	89	KIT
CTTCCCAGTTCACCAGTGGATT	GTTGAGCAAGGCAACCATTTTCT	89	CTNNB1
CCCTCCTTCCTAGAGAGTTAGAGT	TCACTTTGCGTGGTGTAGATATGATC	74	RET
ATGTTAAATTCTTGGCTATTACGACAGACT	ATGACACTGGAGGTGTCCAATG	72	CTNNB1
CACTGATTAACGGTTTCTGTTACATTGTG	AAAACCAGGTTTCATACACAGTCCA	85	FBXW7
AGGGTATTTGAAGTATACCATACAACTGTT	AGACTGGCTTAATGGCAACGAA	74	CTNNB1
GCTTGGTTTCTTCAGTCCCATTC	AATTTATTCGAAACCTAGTCACATTGGAGA	72	FBXW7
GGTAAGGTGCCCACCTTTCTC	GAGGTGGGTGTTATGGTGGATG	92	ERBB2
TTTTAATGTGCCGTAGAAACCCATATTTTC	CCACATTAGAATCTGTGACATACCTACCT	77	FBXW7
CCCTGGTCACCTACAACACAG	CCACCAAAATGAGAAAACTGTGTTTCTC	83	ERBB2
ACTCACTTTTGTTGTTTTTGTATAGAATGGG	TCTGATGATAGTAGCAGAGAAGATGAACATA	63	FBXW7
AGCACTCTGACTGCCTGGTA	TTTCACTGTGCTGTTTTGCCC	92	ERBB2
CATCAGACTGATCAAAATCGTCACTCT	GGTAGATGAGGACTCCTCAGGAAA	79	FBXW7
TCTACAGCGGTACAGTGAGGA	GCCCATCAGTCTCTCTGCTTAGA	80	ERBB2
TGTTTTCTTCCAACTGTCCTTGCT	GTGGTAGAGGAGGAACAGCAACAG	87	FBXW7
GCCCAGCCAGATTATCCTTTCTG	AAATGACACGAATCATTTGGGAATTGATT	74	IDH1
TACCACACGATTCATCTGTTCTTCATC	CAAGAAGTAGCAAGCTGGCTTT	88	FBXW7
CGTCACTTGGTGTGTAGGTTATCTCTA	CTCCTTACAATTCCTGCTAGGGTATTTTT	71	IDH1
GAGACTTACCCGTCTTCGACAA	ATGGCTTGGTTCCTGTTGATCT	80	FBXW7
GGTTCAACTACACGAATGGACCAT	CATTAGTGACCAGGGTTTGTAATCTTCT	79	APC
AGCGGCACTTGTACTCCG	AGACTATGCCTGCAGCTGTG	98	NOTCH1
AGAATATTTTAGACTGCTTAAAGCAATTGTTG	CCGGCTTCCATAAGAACGG	85	APC
GTGAGCACTCGTCCACCA	CGCAGGTGTTGACGTTGC	94	NOTCH1
GAGTGCAGTCCTGTTCCTATGG	GGAGTACACAAGGCAATGTTTACTATATGA	86	APC
GCAGTCGTCGATGTCGGT	CATCAACGAGTGCGTTCTGAG	87	NOTCH1
TGCTGATCTTGACAAAGAAGAAAAGGA	ATTAAAGTTTCAAATAAGTTGTACTGCCAAGTT	75	APC
CGCTTGAAGACCACGTTGG	CGGAGCATGTACCCGAGAG	100	NOTCH1
ACTGCATACACATTGTGACCTTAATTTTG	CCACATGCATTACTGACTATTGTCAAACTA	78	APC
CCACTCACTGGTCCTTTCACTC	CCGGTCTTCAGAAGGTTGAAGAG	82	RET
TCTTTCTAGCTCATCATACTGGCTAGT	TTACTAGAGCAGACAGATAGCACCTT	77	CTNNB1
GGAATCTCTACCCTCAGGCCATT	CAGCTTGTACTGGACGTTGATG	89	RET
CCTCTTGCACTCTGAATTGGGA	GCTACTCTTTGGATGTTTTCAATGGG	88	CTNNB1
GATGGCTTGTTGTATACTGAGTTGTATCT	TCTGAGAGGCCGTCGTCATA	90	RET
CTCTGTGAACTTGCTCAGGACAA	TCTGCTAAAGGCTTTGGTTCCTTTTTA	84	CTNNB1
CCTCCCTTCCACATGGATTGAA	ACCAGAAACATTTTTAAAAAGCATCACAGA	75	RET
CCAGACAGAAAAGCGGCTGTTA	GGAGGTATCCACATCCTCTTCCT	89	CTNNB1
CCTTACTCATTGGGTGGCCG	GCGTACTCCACGATGAGGA	100	RET
CCTGTATGAGTGGGAACAGGGAT	ACACTAACTTTTTAGTTCTCAAAACTGCAT	71	CTNNB1
TATGGGCTGTGTGGGACGTG	GTCTGCATCGAAGACACGC	100	RET
CTTTGGATGCCCTAACCTCAGT	GGCCATATCCACCAGAGTGAAAAG	93	CTNNB1
CAGACCTTCCGGGTGGAA	CGAGCACCTCATTTCCTGGG	100	RET
CCCATGATGGAACATGAGATGG	GGCCAGCTGATTGCTGTCA	87	CTNNB1
CTCGGAGAACCGCACCATG	GAGGGAGTAGGTACTGGGCA	99	RET
ACCAAGCTCTGCTCCACAC	ACAAGTCCAAGAACGCTGCT	94	ERBB2
CTCGGAAGAACTTGGTTCTTGGA	TGCCTGGCAGGTACCTTTC	97	RET
CCTTGCCCAAGATCTCCAAGTA	TTGTGAGCGATGAGCACGTA	93	ERBB2
GCTTACTGGGAGAAGCTGTATGTG	GTACGTGCCGTAGAGATGCT	81	RET
CCAGCTCTTTGAGGACAACTATGC	CCTGTGAGGCTTCGAAGCT	82	ERBB2
TAACCGGAGCCTGGACCATA	AGTGTCAGCGGCTGTGATAAG	85	RET
CCCACTCCTTTAATCTCACCCT	TGCTCACTTGTGCAGAATTCGT	85	ERBB2
CTTGTCTGCCACCTGCAGAT	CATCTCCTTGCCTCCACTCAC	96	RET
TTCTACGGACGTGGGATCCT	GGCAGTGAGTGGGTACCTC	86	ERBB2
TGGGTCCCGATCCTGTGTC	CGGCACCTGCAAAGACATGA	96	NOTCH1
GCCTGACCAACTTTTCCCAGTTT	CTTCTTCTGCCAAAATTGTTGTTTCTAGT	84	FGFR2
GTTGATGTCACAGTTGGTCCCA	CCCATAGGGCATTGCAGACC	97	NOTCH1
CCGGCATGATGGTGGATTCTAC	CTAGACCCACAGACTGTGAACAC	90	PDGFRA
TCATCTACGGCGTTGACGTC	CTGATCCGGAACCGAGCCAC	99	NOTCH1
GCTCTCATGTCTGAACTGAAGATAATGA	CATGTGTCCAGTGAAAATCCTCACT	74	PDGFRA
CCAGGCCACATCCAAGTTCAG	TGTGACAGCCAGTGCAACT	89	NOTCH1
CTGATCCGTGCTAAGGAAGAAGAC	ACAGAGCTAGCATTATCTTTATACTCCCT	80	PDGFRA
CACAGTGGCCGTCACTGAA	CCTGCAGTGCAACAACCAC	86	NOTCH1
GCTCCTGAGAGCATCTTTGACA	TTCAGAACAGCCCAAATAAGCAGCAAT	78	PDGFRA
GCAGGCTGCAGACCTTGTT	GGCTCTTGTGCCACATCCT	93	NOTCH1
TGAATTTAAATGGTTTTCTTTTCTCCTCCAAC	CTTGATGTCTCTGGCTAGACCAAAA	74	KIT
TGACCTTGTCAGTTTCACTGCC	CTGCAAGAATGGTGCCAAGTG	95	NOTCH1
AAAACTTTCTTTCAGTGATACATTTTTCCTG	AACTTACCTTTAGCTAATAAAAATGTGATCCA	72	RB1
CGTGCGGTCTGTCTGGTT	CTCATGATCGCCTCCTGCA	91	NOTCH1
CTGTGATTCTTAGCCAACTTGAAATGAAG	CTCTGCATTTGCAGTAGAATTTACACG	68	RB1
GTTGTCCCGGACTCAGCT	GCACAAGGTGTCTTCCAGGTAG	99	NOTCH1
AATACAGTTTTAACATAGTATCCAGTGTGTGA	ACTGCTGCAATAAAGATACAGATTCCC	72	RB1
GGCTGGAGCACTCGTTGAT	TGGACATCGATGAGTGCGAC	95	NOTCH1
CAGTTGACCTAGATGAGATGTCGT	ACAAAAGTCTATTGAGAGGAAAATCCAGAA	84	RB1
GCAGCCATTGATGACGGAC	TTCCACTGCGAGTGCCGTG	100	NOTCH1
GCCATCAGTTTGACATGAGCAT	GCTATCATTCATTTTCTGCTTTTGCATTC	88	RB1
TGCAGATGCACTGGAACTCC	GCTCCTTCGAGTGCCAGTG	95	NOTCH1
TGTTATGTGCAAACTATTGAAACAAGTATGTAC	TTCTGACATAATGCAGTAAAATCAGGTTCT	76	RB1
AGACCTGACTTCTCTCTGCAGA	GGTGTTGAAGAAGGAGAAGTATACGC	91	RET
GGAGAGATGAGTCCAGTATGCCA	CGGTAGAAGGTGCTGTCCAA	94	ERBB2
GATCATATTGGCCTGTCTGCTCTT	GCACTCACTCTCCTCTTAACCATC	91	RET
CCTGGTGGATGCTGAGGAGTA	GCCACACAGTGTGACCGA	100	ERBB2
GCTTCCAGGAGCGATCGT	CCCATACAATTTGATGACATGTGGG	94	RET
GGAATGCCGAGTACTGCAGG	GCAAACAGTGCCTGGCATTC	99	ERBB2
GCTGAGTGGGCTACGTCT	TCGCAGAAGCACTTCTCCTC	90	RET
CGTCCTCTCGCTGTTAGACATC	CGGCTCTGACAATCCTCAGAAC	80	ERBB2
GATCTGTTTTCATTTTTAGGCATGTCAGA	TGAAAGCATCCAGTTAGCATATACACTATC	78	RET
ACGAGACAGAGTACCATGCAGA	AGTCCTCCAACTGTGTGTTGTG	90	ERBB2
CTCCAGTTGCTCCTCCCTAGA	CTGGGAGAGCAGGTGGAGAAGT	93	RET
GGGAAAGGGTCCTCTGATCATT	GTTGTTCTTGTGGAAGATGTCCTTC	79	ERBB2
GACATCTCCTCGGGCTTACA	CCTGTGGGAGATCTTCACTCTG	96	FGFR1
GGAGTGATGTCCACCCTGTT	ACAGAGCCCACCTGTGATCT	99	ERBB2
GCAGCCTTACCTGGTTGGAG	CTGCCGCAGGTACATGATGAT	83	FGFR1
GGCATCTGCCTGACATCCAC	TGCATACACCAGTTCAGCAGG	83	ERBB2
GCAGAAGCATCTCACCGAAATC	CATTTTTGCAGCTCTCCTTCTATTTGG	77	FGFR1
CCATCATGACTTTCTTTCTTGTCCC	CCAGGTCACCATCAAATACATCGG	90	ERBB2
GCAGCGGCTCATGAGAGAA	CTCGCCCATCACAGGAGTAC	86	FGFR1
CCCAACTAAGGGCCTGATCCTA	CGCAGAAGGGAGGGTCCTTA	85	ERBB2
CCACTCCTTGCTTCTCAGATGA	GACAATGTGATGAAGATAGCAGACTTTG	84	FGFR1
GTGAAACCTGACCTCTCCTACATG	AGTCCTCCTTTCTGCAGAAAAGAC	76	ERBB2
CCTCTGTCACCAGGACATTCCT	AGACAAGTCGGCTAGTTGCATG	94	FGFR1
GTGCACCGGCACAGACATGAA	GTGGGCAGGTAGGTGAGTTC	84	ERBB2
GCTCACAGGCACACTCGTAG	CTGAGGACTGACCGACACGT	91	NOTCH1
TTTTTGAGGCTAAAAGAAAGAAAATGGTATT	GGTCTATATTCTTCACTTTGCATATGCCA	79	RB1
CTACCCAGCGAGCACTCAT	GACGCATGCATCAGCAACC	101	NOTCH1
TCCTTTAGCAAACTTCTGAATGACAACA	CCACATTTTAACTTTAAATTGAACAAAAGTGTT	78	RB1
CGCTATGCCTGTGAGTGCA	TGTGGACGGCGTGAACACC	93	NOTCH1
ACCCTGCGATTTTCTCTCATACAAA	AATAGTCAAGGACACATAGCATTAACTGAAA	83	RB1
GTAGGAGCCGACCTCGTTG	TGCCCTTCGAGGCCTCCTAC	100	NOTCH1
GTCATCGAAAGCATCATAGTTACTGGA	TTACTCATTTCTGCCAGTTTCTGCT	87	RB1
TGTTCTCGCTGCAGTCCTC	GTACTGTACCGAGGATGTGGAC	95	NOTCH1
CCCTGCATTGTTCAAGAGTCAAGA	ATGTTACAAGTCCAAGAGAATTCATAAAAGGTA	81	RB1
GTTATCCTGGGTGCAGGAGG	GCCTCCTTCTACTGCGAGTG	99	NOTCH1
CTACCTTGTCACCAATACCTCACA	GCAGACCTTCTGAAATTTTATATGGACTCT	74	RB1
GTTGTTCTGCATATCTTTGTTAGCCC	CAGCTGGTCTCCAACCTACC	89	NOTCH1
CAGTAAAAATGACTAATTTTTCTTATTCCCACA	GTGCTGGAAAAGGGTCCAGA	78	RB1
ATAGAGGGAGTGAGCAGAGCCT	ACGACAACCAGAATGAGTGGG	92	NOTCH1
TTTTTCTATTCTTTCCTTTGTAGTGTCCAT	TCCAATTTGCTGAAGAGTGCAAAC	85	RB1
TGCACGTGTAGCTGTCCAC	GCATCAACACGGCCTTCTG	96	NOTCH1
CACTTTTACAGAAACAGCTGTTATACCC	TCATGTTCTTTACAGAGAACTTCAATAATTCT	77	RB1
CCTGTGTCCCGCAGACATC	GGAGTGCAGGCAATCCGAG	86	NOTCH1
TGAGAAGTTCCAGAAAATAAATCAGATGGT	TCTGCTTCATCTGATCCTTCAATATCAAAG	71	RB1
CGGCTCTCCACTCAGGAAG	CTGCAGCCAGCAAACATCC	87	NOTCH1
CCTGGGAAAATTATGCTTACTAATGTGGT	AGATTAAGAGGACAAGCAGATTCAAGG	83	RB1
GGCCCTGGTAGCTCATCATC	CCAATACAACCCTCTGCGGG	99	NOTCH1
TCTGTGTGCTGAGAGATGTAATGAC	TGATCCAAAAATAATCTTGCATCTAGATCTTTA	81	RB1
GCACCTTACCTTGTTCAGGCAA	TGTGGAGCCTTGTCACCAAC	96	FGFR1
GGGTCGTCAAAGACGTTTTTG	GTCCCAGTAATAGAGGTTGTCGAAG	90	ERBB2
GGGTCTTCGGGAAGCTCATAC	CTTGCAGGTGTCTGCTGACT	87	FGFR1
GTTGACCTGTCCCGGTATGAAG	CCTGGATATTGGCACTGGTAACTG	81	ERBB2
GAGGCCTTGGGACTGATACC	GATGATGAAGATGATCGGGAAGCA	95	FGFR1
GGGTTACATGGTGGCTTGTG	AGAGGAGTAAATAATTGGAAAAGTAATCAGCAT	76	FGFR2
TGATGGGAGAGTCCGATAGAGTTAC	CTTCTAGACTGCTGGAGTTAATACCAC	73	FGFR1
GGACAGGCAGACACAGTCATTC	AGTTCTTGTTCTTCAGGAGATGATTCTG	74	FGFR2
GAAAGCAGGACTCTACAGTGCT	CGACTGCCTGTGAAGTGGATG	95	FGFR1
ACAATGCAAGGGTAGCTGATTCTAAA	GGCCCTCCTTCAGTTTAGTTGA	91	FGFR2
CACCATGCAGGAGATGAGGAA	AAGCCTGCTAACACCCTGTT	83	FGFR1
GGACAAGGTTGCCATGGTGA	GAAGTGTGCAGATGGGATTAACG	81	FGFR2
GGCACCAGAGAAGCTGTTCTG	ACCCAACCGTGTGACCAAAG	91	FGFR1
CTGAAAGTGGAATGACCACTTCAGA	GGGACATACTGTGTAGTATCAGCCT	88	PDGFRA
TGTCCTTGTCCAGCCCGATA	CCTCTCAAGGTTTGAACTTCACCA	95	FGFR1
AAAGGAAAGAGGTTTCTAAATATTCCGACA	ATTAAACCACTGGAAAGTCCCAACA	79	PDGFRA
GGAGCCTTCAGGTTCCACAC	CCAGGGCTGGAATACTGCTA	99	FGFR1
TCTATTTGCTAATGCTGTTTCTGTTGACT	CAAACAAGGAACTCAGAGAGGACTG	84	PDGFRA
CTGCTGGTTACGCAAGCAT	CGATGTGCAGAGCATCAACTG	97	FGFR1
AGACCCTCCTTTTACCACCTGA	CACAGCTCACTGGTATAACTTCCAG	78	PDGFRA
AAAGCATGTAATCAGGACTTCCTAACTC	ACACTGCGCTGGTTGAAAAATG	89	FGFR1
CCTGGCTATCCTGTGGATTTTTAGG	TTAAAAACAGCACAGGTGACCACAAT	86	PDGFRA
CCACTGGAAGGGCATTTGAACT	CCTGTCTCTCTTGGCTTTCCC	81	FGFR1
CGGTCCCAACCTGTCATGAA	GCTGCATGATTTTGAGAAATTCCCTTAATA	77	PDGFRA
ACTTCTTTCTGCCTCTTGCAGTT	TTGCATATCATCCACTCAATATCAGGAAG	83	PDGFRA
GTCCCTTAGTGACAGTGTCTACAC	GGTTGGGTTTTCCTTACAAGCAAG	76	HNF1A
CTCTGAAGAGAGTGCCATTGAGA	TGTCTTCCACCAGGTCTGAAGA	82	PDGFRA
GGTGAGAGTGGCCAGTACC	CCCACTTGAAACGGTTCCTC	98	HNF1A
CCATTGACACATCCATATCATCCAGA	GACTTTGATTTCTTCCAGCATTGTGA	87	PDGFRA
GCATCCCAGCAGATCCTGTTC	GACCAAACCAGCACTGTTTCC	82	HNF1A
CATCCATCAAATTGGTGTACACTTTGAC	CCATGGACAGAAATAGTGACTTTCTTCATT	74	PDGFRA
AAAGAGCTGGAGAACCTCAGC	GGGCTCGTTAGGAGCTGAG	97	HNF1A
AAAAATTCACCTGGACTTCCTGAA	CCTCCCAGTCCTTCAGCTTG	80	PDGFRA
CGTGTGGCGAAGATGGTCAA	CTTCATGGGAGTGCCCTTGTT	84	HNF1A
AGTGGCTACATCATTCCTCTGC	TCTCCTTCAGGGCCTATAGGG	94	PDGFRA
CACAGCTTGGAGCAGACATC	GCACCTGTGTTGGTGAACGT	93	HNF1A
GGTGCACTGGGACTTTGGTAAT	ATCGGGTCCACATAAATATATTCATGTCC	80	PDGFRA
AGTCCAGAGCTAGCGAGCCG	CAGAGGAAGAGTCTGGCAGTTG	93	ALK
GCCTTATGACTCAAGATGGGAGTT	TATTCTGCCAAGGCCTATAAATTGTAAAGT	71	PDGFRA
CCCGTATGGCTCAACTTCGA	GCTTCAGACCGTGCTATCGT	99	VHL
TCAAAAACCTCCTTTCAGATGATAACTCA	GGTCTAAAAAGGTCTGTGTTCCTTGAA	82	PDGFRA
CGACCGGAAGTCCATCTCCT	TGGAGCTCCTGATCTGGTACAG	86	AKT1
CCACCTTCAGCCAGTTGGAAG	AGTGAGATTTTCAATCAGAGTCAGATTGT	77	PDGFRA
CATGCTCTCATGCCTGGGAT	CTGTGACTTCCACCAGGACT	99	ALK
AGATCACCACTGATGTGGAAAAGATT	TTTGGGTCTGGGTTGTAAGACAC	77	PDGFRA
GTCCCATTCCAACAAGTGAAGGA	CCATGGGACCAACCCATCA	95	ALK
CATCATCACAGAGTATTGCTTCTATGGAG	TGCTTTCATCAGCAGGGTTCAA	85	PDGFRA
GGAATTGCCGTTTAGCCCTAG	GTCAGATGAAGGATGGAGTGCC	96	ALK
TAGTTGGAGTCATTCATGATGTCCCTA	AGACTAACCCTGCAGTGCTTTC	85	CSF1R
GTCAACCACCTTGACTGACCA	CCCTTCCCGATGTTCTCAAACAA	80	STK11
GTAGACACAGTCAAAGATGCTCTCT	GCAATGTAAGTGCTGGGAGGG	93	CSF1R
GTGAACGCTACTTATGTGAACGTAAAAT	ACTAGCACTATGATGTCTCCCAGAA	73	MET
ATCCTGAAGATGTTCGTGGACC	CTTGAGGTTGAGCTGCAGGAT	94	GNA11
CTGTTTTGGCAGATAAACCTCTCATAATG	GGACTTTGCTAGTGCCTCTTTACAC	70	MET
CCTTTCAGGATGGTGGATGTGG	ACCTCGTTGTCCGACTCCA	98	GNA11
TCTTTAACAAGCTCTTTCTTTCTCTCTGTT	TTCTGTAGTTGGGCTTACACTTCG	75	MET
GTCTCCACGCAGAGCCACAG	CGCCTCCTTCTCTAGACAGG	88	KDR
GGGACTCGAACTCTAAGCACAT	CCGTAGACAGCTTTGGTGTGAT	94	GNAQ
TCATTATCTTTAAACCACATGATCTGTGGAG	GTGTCTAGAGCGTGTGGCA	84	KDR
AGAAGTACAAGGCTGTGTCCATC	GTTTCAATTTAACTTCAACCCAACCAGT	88	SMARCB1
CACTCTTCCTCCAACTGCCAATA	GAGAAATCTCTAATCTCTCCTGTGGATTC	72	KDR
TGTCCTTACCAGAACGTTGTTTTCA	ATCCATTGGAAGGGCAGGCC	94	TP53
GACTATTTTTAAAAGACGTACTTACATCTGGGA	TCAGTATCTGCAGAACAGTAAGCG	67	KDR
AATCTTTGCATAGCACCTGAATTGC	CTCAAGACAGGAAGACCAAGAAAAGACATT	83	KDR
ACTTAACCAAGCACTGGGTTCA	GCACGAAATATCCTCTTATCGGAGA	90	KDR
TCACTGTTCCATAATGAAGTTAATGTCTCC	TTCCCAGGAGCGAGAGGACATTG	86	MET
CGGTAGAAGCACTTGTAGGCT	TGGCTTTGGCCCAATAATCAGAG	92	KDR
CCATCAAATGATATTTACATGTACCTTTTGTGT	CTGCAGCCCAAGCCATTCAA	83	MET
GCAAGGCAGACATAGTCTCCTT	CCACACCTGTTTGCAAGAACTT	91	KDR
GGAGATGTTGCATAACCACTCCTT	GCTTGTTCACACACTCAGCTGA	82	MLH1
GCTTGTACCATGTGAGGTTCTCA	TCAATAACTATGGCCTCTTCATTTTAGGG	85	KDR
GTACCACCCACATTGCCAACCA	GGAAGTTCACAGAGAAGTCTCGAGA	77	MPL
GGAAAAATTGTGAAGATCTGTGACTTTGG	CTGACTTTAGAGATTAAAGTGAAGGAGGAT	80	PDGFRA
GAAGTTACTGTGCTCACATTTGTGAG	ATACAGCACCCAAATCAAGAAACCT	88	ALK
AAACTTTTCATTGTGCCTCTCTCTCT	AATATCTACCTGTTTCCAAATGACAACCA	84	PDGFRA
AGGTGGGAGGAGAAATTAGAGAACT	CTCTATTGCTCAGTACCACTGATGTC	88	ALK
TACTTAGGCCCTTTTTCTCTCTAGATGT	CCACTTTGGCGAAAGTCACAC	90	PDGFRA
GCAGGGATACCTGGAGGATGAT	CAGGGCGAGCTACTATAGAAAGG	92	ALK
CAGTGGGATAGTTTTTCTGGATTTATGTG	CATCCTCCACGATGACTAAATAATCCG	83	PDGFRA
TGGGAGAGACAGTCAGGCTT	GCTTTTGACAATATCTCCATCAGCCT	91	ALK
GGATGATGATTCTGCCATTATACCTTGTC	GTGAAGGTCCCATTAAAGCCCT	74	PDGFRA
GGAGGGTGTTGAGTGTTGGT	GATGACATGCTGTACATCCTGGTT	95	ALK
AATTTGTAGACCCTCTTAAGATCATGCTTT	CCACCACATCCTCTAGTAAAATTGATAGT	80	ERBB2
ATCCTTCTCCAGGTTGAAGATGC	AGCCAACGTTCTTTGTCCCAT	81	ALK
GAGACTCGGACTCCCAGGA	GAGCCTGTTCTTTCCAAGGGT	87	SMO
GATCTGTTAGAAACCTCTCCAGGTT	GCCTGAAGTGTGCTCTGAACAG	87	ALK
GCTGGACCCAGTGAAAATGACC	TCTATCTCCTGCAACCACCACTA	85	ABL1
AAGAAAAACTGCTTAGTAACTAGCAGAAGT	AAAAGCAACCAGGAAGTTCTGGA	72	ALK
TTGGACACAGCTGACCCAGC	TCAGCGTGCTGGACTTCTTC	89	ABL1
CTCTCTTGCAGCCTCGTTGT	CATCCTGAGTCCGTGGATGA	86	ALK
AGGGCGTGTGGAAGAAATACAG	GTAGACTTCCAGGCAGATGCAT	90	ABL1
CTGCTCACCAGTCCCGAA	GACTGAGGATCCGCCTGATG	86	ALK
TTTTTCCTTCTGCAGGAGGACA	CGCGAGACCCTCTCTTCAGA	94	ABL1
GGACTGACCTAAGCAAGTTTGTTCT	AATGCAGCCTCAAACAATGACC	92	ALK
TTTTTCTCCCAATTTTCTCTTCCTTTTTCT	GGTTTTCCTTGGAGTTCCAACGA	85	ABL1
GATGAAGTGGTTTTCCTCCAAATACTG	TGACAAGCTCCTCGTCAGTG	87	ALK
ATATGGCTGAGTCTTACCCAAAAGATG	AATTAACTGTGCCATCTCATTGTCTCTTA	80	KDR
CTGTGTAGGAGGGACCTCTTCT	GGAAAGAAGAGACGCACTTCCTC	91	MPL
CCATGAGACAGTTCAGGCAGTA	ACGTTTTCAGAGTTGGTGGAACAT	91	KDR
CTGACTTGGTTGTGTCGATCTCT	CGGAGGATTATCGTTGGTGTCA	94	CDH1
AAACCTGTGATCTGAAAAGATAGCTGAT	AAGATCTGTATAAGGACTTCCTGACCTT	83	KDR
GTGAAATGCAGCAGCCACTAAAG	GCCCTGTTTGATAGAGTATACACTCATCA	86	FGFR2
TGTGCTGTTCTTCTTGGTCATCAG	CCGAGACCTAAAAACCCAGTCT	92	KDR
TGAGAGTGAGAATTCGATCCAAGTCT	CCCAGTGCATATGAAATTAATTCAAGGAAA	82	FGFR2
GTATCATAATAAATCTTGGGCAGAGAGGAA	GACACAGGAAATTACACTGTCATCCT	71	KDR
GCAGGCCTTTGTCCTCCTAA	GCATGTCTGAGCAGTACCAAGTG	82	JAK3
TCTTTCACTCACTTCCATAATCGTCAG	GTGTGAGAGCAAATCCTTTGACTATACTAA	77	KDR
CTCCCGCACCCAGTTCAAC	CACCCTTCTAGGCTCCAAGG	95	SRC
GGTAGTATTGGACTTTTCCCATGATCA	AGGAGAAGTCCCTCAGTGATGT	90	KDR
GAGCTCTGGCTACTGGTGATG	AGGAGTTTGTTTGTTCCTTTGCTTTTT	81	KDR
CACAAAGTGACACGTTGAGATTTGAAAT	CAGATCTCCATTTATTGCTTCTGTTAGTGA	66	KDR
GGGCTTATTATCTAAGTATTTGGAGGTCT	CTTGTCTTAAATTGTACAGCAAGAACTGAA	66	KDR
CAAGCTTTTCTCCAACAGATAGTTCAATT	AAAGTTATAGGCTTATTTGCTCTCTCATGT	66	KDR
TGTCCTCTTACCTACAACGACAACT	AGAAGGGCTTTACTATTCCCAGCTA	74	KDR
AGCAGCCTGGAAAAGTACTTGG	ACCATGTTCCACAAAAACATTGCAG	83	ABL1
CATCTGCATGTGTGTCTTGGGTA	GGTGTTGCCTCTCCTCGAT	97	ALK
AAGGGCGTGGTCCTGGACA	ATAGCTCACGCAGAACGTGTAG	84	ABL1
ACAGGCTCAAGCCTTCATAGG	CGAATGTCCTGGCTCATTCGT	84	ALK
TGGATTCCATCCAGCAAATGAGG	GAGCTTGCTGAAGTCCTGAGT	95	ABL1
TGTCTATGTGGGCATGAAGATGG	CTGGACCCAAGGCACACTGT	94	ALK
TTCGGTGAAGGAAATCAGTGACA	GCTGACTCACTAGTCCCTTGTCA	92	ABL1
TCTCTCGGAGGAAGGACTTGAG	CCTCTCTGCTCTGCAGCAAATT	87	ALK
GATCCTCTGGACCATGAGCC	TCTTGATCAAGGCGCTGAACA	97	ABL1
ACCAATCATGATGCCGGAGAAAG	AGTGGGACCTGTCTTCCAGT	82	ALK
CGGAGTGGAGGTCAGTCAC	CACCTGGTCAGACCTGTTCTC	99	ABL1
GAGTCTGCGGTGCTGTGATAA	CAAGACCTCCTCCATCAGTGA	93	ALK
GCTGCTGATGAGGTCTTCAAAGA	CCCTTTCCAGCTTCTTCCTTGT	94	ABL1
GCGGAGCTTGCTCAGCTT	GTGTAGTGCTTCAAGGGCCA	100	ALK
GTCCAGAGTGAGGAGGCACA	CTCTGCGAGGGCTTTCCTC	95	ABL1
GTAAACAGAGCAGAACAGGAGTGA	GGGCAGAGCGTTCTAAGGAG	90	ALK
CTCCAAAGCCACAGTCCGCC	TCGGGTTGATATGAGAGGGATGA	96	ABL1
CCCATCCAGCAAGTCCATCTG	GTCTGGAGTGCAGCTTTGACT	88	ALK
TCAGCAGTGGTGGATTTGTGAA	GCTACCTTCACCAAGTGGTTCTC	79	ABL1
GAGTAAATGTTGACCAAAGGGAGAAAATG	GCTTCTTCTTTTAGATACCGGATAATGACT	80	ALK
GGACACCTACACAGCCCATG	CCACTTCAGTGCAGCAGCA	88	ABL1
CCCAGGCTGGTTCATGCTATTC	CCTTGTGGGAATGTCAATTACGG	80	ALK
ACTGAGTTCATGACCTACGGGA	ATGAAGTTTTTCTTCTCCAGGTACTCC	87	ABL1
CGGAAGTCTCCCAGTTGCAA	TGGTTTACAGAGAAACCCACCAAAAA	79	ALK
CTGTCCCAGGAAATTCTGTTACCA	CTTCAGTGATCATTGTACATGGCTCT	76	KDR
GTACTTCGCAGGGATTCTGACA	AATGACCATTTACAGTAAGTTGACCTTTTT	83	KDR
GCAAAGGACATGATCAGATTCCTTTTTAC	CCAGGCATGCAGTGTTCTTG	90	KDR
CCTTCCTCACTCTGCGGATAGT	TCTAAATTTCCCTGAAAAACTTCACAGACT	73	KDR
GCAAGGAGAATTTGCGAGCAAAG	GGGTAAAGATTGATGAAGAATTTTGTAGGC	85	KDR
CTGGAAATTATTTCCACTCAATAAACAATCAGT	CAGGCTCAGCATACAAAAAGACATAC	79	KDR
TCCTCAGGTAAGTGGACAGGTT	GGGTTCATCACTATATTAAACGCTTAGTGA	85	KDR
TGCATGGGCAGAAGGGAAATTA	CAGGAAAAGACGAACTTGGAAATCATTATT	80	KDR
TGTGTGAGTGATCCAACCCAAA	GTTATCCAAGCGGCAAATGTGTC	91	KDR
GATACAAGCCTTGCAACATATTTAAAGACT	GAAGCAGATGCCTTTGGAATTGAC	85	KDR
CAGGAGAGGAAAAGACAACTTTTGTCT	ACAGAGTGTACACAATCCAGAGTGA	87	KDR
GAAGAGATGGCCTGGTAAACACA	CAGATGAACTCCCATTGGATGAACA	91	KDR
CGGGTCTTAGGCTATAATCACAATGG	CCCATGGTACCAGGAGTGTTTC	77	ABL1
GTGCAACTCCGAAGGAGGGT	CTGGCAAGGCTGCAAAGAAACC	82	ALK
CGGGATCAATGGCAGCTTCTT	CCTACCTTGCCATCAGAAGCA	83	ABL1
CGCTCCTCCTCCCGTTTTG	CGGATGTAATCAACACCGCTTT	97	ALK
AGTTGGTTCATCATCATTCAACGGT	GTTCCATCTCCCACTTGTCGTA	78	ABL1
GGCTCAAGAGTGAGCCACTT	CCTCTTGTCTTCTCCTTTGCACA	96	ALK
CAGATGAGCACTGTTACCTTACAAAG	CACGGACGCCTTGTTTCC	95	ABL1
GCACAGGAACCTGGTGGAAATC	TAGAAGAAGAAATCCGTGTGAACAGAAG	75	ALK
CTCCAGGAGAGCTGCAGAGCA	CTGAATGTAGCCTCTGGCAGG	96	ABL1
CCCTCTTCCATACGCACCTG	CACAGTGCAACAACGCCTAC	85	ALK
TTGGGAAATTGCTACCTATGGCAT	TCGCATGAGTTCATAGACCTTCTCT	83	ABL1
GGTACCAGGAGATGATGTAAGGGA	CCAAGATTGGAGACTTCGGGAT	93	ALK
GTTATATTTTCTCATTAGAGCAAGTTACTCAGA	TTCAACAATTTACTCTCCCATGTACCATT	62	MLH1
GGACAGGTCAAGAGGCAGTTTC	TTCAGCTTGGAGATAAAATCCTAGTGATG	73	ALK
AGTCCTCCACACTTCTCCATTCT	AGTCTGAATCTTTTCCTTACTCTTGACTCT	85	KDR
CCGTGGTCACAGAAGCAGATG	CCTCCTTGTCACTAGTGATGGAAG	87	ALK
CGCTGTCCACACACTCCAT	CTGGCCGTGCTTTAAGAGGT	86	AKT1
CAGGAAAGGGAAGGAGTCTTTCA	AAGCACATGGATCAGTGTTTTCTTTATTTT	86	ALK
GAGTTTGTTATCATTGCTTGGCTCAT	GCCTCCCTCTTTAACAATCACTTGAATA	82	MLH1
CAAAGAAGTCCACTGCAGACAAG	CTTTTCTCCTCTGTTTTCCAATGCA	88	ALK
TGATAGAAATTGGATGTGAGGATAAAACCC	GTGGATTTCCCATGTGGTTCTTTTT	84	MLH1
ACTAAGCAGGGAGGGAGTGA	CCAGGCCATGAAGAAGTGGG	99	ALK
TATTTCTTGTTCCCTTGTCCTTTTTCCT	TGATCACTGACCTCAGTGGCTA	89	MLH1
GCCCAGAGCAAGGAAGTGTTA	GTCCTGCATCCTGCTTCTCT	84	ALK
CCTCACATATTATTGTACCATCCTTCCA	ACTTCCAGGGAGGAAATAAAATTGAAGTTA	80	KDR
CGGAGTGATATCCGGACTGGTA	AAAGAATTGTCTTCTCTCTGCCAACT	88	KDR
GGGATGTTAGGCCATATACAGTACC	ATGGAAGAGGATTCTGGACTCTCT	81	KDR
CCCATCAGGGATAGGGTGGTT	GTCCACAGCGCAGGTGAAAT	90	GNAS
CGACTGCCGTGACATCATTC	GATTAACTGCTTGTACAATTACGTTTCACT	82	GNAS
CGCTTCTCCCAAGCATTCACA	CTGGAAAGTAGTCCTCAATCTTCGATT	91	GNAS
CTCCAGACCCAACTTTCAGGTC	CTCCAGTGTAGGCCAGAAGC	96	GNAS
GCCAGACGCAAGATCCATC	CCTTCATCGTAGTACACGCGG	99	GNAS
GCAGCGACGATGACTCCA	GAGAAAGTTGCGGAGTAAGTTGC	83	GNAS
GCTCTCTCAAGGTCAAGAAGGTAC	GAGTTGTTTGTCGATGAGCTTACTG	75	GNAS
GGTCCATGCAGGCCTTGAG	GGCAGGCTGGTCAAACTCA	94	GNAS
AGTTATCGCACAAGTCGACGG	GTCTGACAGCCTCTTGGGAT	98	GNAS
TTGTTTAGATCGTCTGGTAGAATCAACTTC	CTTGGTTGAGGAGTTTGGTGCTA	77	MLH1
TCCAGTGTATACTCTGAAAGAGCGAT	CCAGGTCTTTCTGCACATTTGG	88	VHL
CCCAGAATGTGGATGTTAATGTGC	GAAGTACATCCTGGAGGAATTGGAG	84	MLH1
GGGCTTCTGGTTAACCAAACTGA	CCTGTACTTACCACAACAACCTTATCTTTT	82	VHL
ACCTTGTTATATAGGCCCAGTTCTAACT	CCCTAGTTCCAAGATGGAAGTAGAAGAA	68	ERBB4
GGTGGTGTGATGGTGATCATCTG	GGAGCGAAGCTCATGACTGTC	91	AKT1
CAGAAGGAACCCACCTGACTG	GTCAGCACGGGATCTGAGAC	83	ERBB4
AAAATCTGAGCAGCACCTCTCAT	GAGATTGGAGTGCAAACCGGTA	94	KDR
CATAGCGCAACAGTTGCAGTTT	TTTGGCTACATCTCTTCTTGATTTTCTAGG	82	ERBB4
GCTCACCTTTCAACATCTTCACG	TTAGGCTGACACTGGGCAAG	88	FGFR2
CCTCAATGTAACAAATATGACAGTAACCCT	GGAAACTTTGGACTTCAAGAACTTGG	79	ERBB4
TGTATCCATTTTCTTCTCTCTGACCTTTG	ATTTTCCCTAAGTTTGTAAGTAGTGCTATATTT	77	GNAQ
GCAGCAACGCGTATGCAC	GACGGGCACATTAAGATCACAGA	98	AKT1
GCTACCTGACCGACGTTGA	GGCGGTACCGGAAGATGA	100	GNA11
CAGCATGAGGTTCTCCAGCTA	TGGACTACCTGCACTCGGA	99	AKT1
ATTTTACATAGGTGGAATGAATGGCTGA	TGAAATACTTTACCTCTTTAGCACCCTTTC	71	PIK3CA
GCTCCTTGTAGCCAATGAAGGTG	GGGTCTGACGGGTAGAGTGT	81	AKT1
CGAGGTTCTCTGTACAAGAGATACC	GAAGACGCACCCTTAGTGTTAGG	76	SMARCB1
CCTTCTTGAGCAGCCCTGAAA	ATGATGTGCGGTCGCCTGC	95	AKT1
ATGGTGAACCGCGAGGTGC	AGGTACTCGAAGGTGGGCC	101	SRC
GTCTGGTGCCATGGAGAGTA	CGCCTCTGCTTTGTCATGGA	99	AKT1
CACACCCTACTTTCTATCATTTACTTGTATCA	CCTCTATCATGTTTCTAGTAGCGCTT	81	GNAQ
GCAAAGAAGCGATGCTGCA	CCCTACATCACAGGAGGAAGG	98	AKT1
GCTTGGTACAGGCACCTAGAAG	TCCCTCTTTGTACTGTATTTGTAGAAGGA	80	KDR
CAATCGCGCTTGACGGC	AGAGGGTACTTTTCCTCCCTCC	100	GNAS
CCCAGCTCTGCTTGAATTTTAAATTAC	AGGCTCGACTCACCAGAAAC	87	GNAS
TTTTTCACCCTAGTTCGGTTGG	GGGATATCGCGTTGTCCTG	88	GNAS
CCGAGCAACCACCTTTGGA	GGCCTCGCCATCATTCTCG	86	GNAS
GCTTTTTAGTCGGGATGTCTTTATGAAAG	AATCGCCTCTTTCAGGTTGTTTTTG	85	GNAS
AGCCTGACCTTGTAGAGAGACA	CTGATCGCTCGGCACATAGT	97	GNAS
TGGTTGAGGAATGTAGAGAGACTGT	CCTACCCATCGCTGTTGCT	94	GNAS
CATCATATTCTGGGAAGTAGTCGACTAGAT	AAGGCTCTCTTTAGAACAATTATCACATACC	74	GNAQ
ATTATGCAAATTGTTTTCCACAGAAATACAGT	GGACACCATCCTCCAGTTGAAC	85	GNAQ
GCACGTGAAGTGGGAGTAGATAATTTT	ACAAAGTGTCCCTCTTGTCTCTTG	81	GNAQ
AGATACTCACTATTTGGTAGAGTCAGATAATT	GATGTGGAGAAGGTGTCTGCTTT	82	GNAQ
AACACCTGGAACATTCAGCTGA	AGCTGGTGTATCAGAACATCTTCAC	92	GNAQ
GACTTCCTTCTTGAGGATCTTCATGG	GTGCCTGCCCATAGACCAT	88	AKT1
CATATCCAGGGAGAAGCACTGT	GGTTCTCTGCATTGAGCAGTAAC	91	SRC
AGCCGAGCCATGGTTTCT	CCTTCTCCAGCCAGGAGGTA	95	HNF1A
TGTGATAGGAAGCTGTGGAGTGA	TATGAGGGCAACAGTTATACTTTCATCG	75	CSF1R
ATCATAGAGGTTACAAGACTCTATGCAGAT	AAGGAATGGTGTGCAACCATCT	72	ERBB4
CCCGTTCTGCTCTTACCATG	AGCTAGTAGCTGAGAGCTCTGT	96	CSF1R
CTTGCACAAAAATTTAATACTGACCCATGA	CAGGATCATTGATGTCAGCTCAGA	78	ERBB4
TCCCTTCGCTTACATATTCTTTGGG	CCTCTTACCTGATCTTGGCCTT	92	CSF1R
TTTTTACTTACTTTATAAACCGTTCCAAAAGC	CCATTAACTCCCAGTGGCACA	71	ERBB4
CGGCATGTTGGAAATCTACTTGATC	CCTTGGTATAACATCTCCATTCCTTCTG	72	CSF1R
TCTAAACCTTCTAAACCTGATGAAAATCCC	CTGTTTATGTTAGAAGGAAGAGCATCAAAA	67	ERBB4
GCTACTCGGAGGAGGACAAG	GGGCTCACCTTGTTCTGCTC	92	GNA11
GTCAGACCCACAATGACCAGAA	TCTTCCTCTGTCTTCTCTCTCTTCATAC	74	ERBB4
GTGGAGAAGGTGACCACCTTC	GCCGCACTTACTACTTGGC	95	GNA11
GATACATGTGGATAACACATACCAGGT	CAAACAGTTTCATTTTCAAGTATGCTGATC	69	ERBB4
TCCCTGACCGCTTTGCTAAATC	TCAAAGTCAGGCACGTTCATCA	95	GNAS
GTTTGGGCCATCTTTAAAATGAGAGC	CTGAAGTCTCAGTAACTAAACCACATGAAT	82	ERBB4
AACAGCTCCCACCACTTAGATG	GAATCAGCACGGAGGGTGA	89	SMARCB1
GTACTCTTTTTCATCTCCTTCCAAGAGT	TGGAAGAAAGACGACTCGTTCATC	72	ERBB4
CAGAACGGTGTCCAGAGCA	TCTTGTAGTGCTTCACGTTGAGG	97	SRC
GTTATCTCCAGGTTGCCCATGA	TGTATCTTCTTGTCTTTGCAGTGTGT	87	ERBB4
CCACTCCTCCTGGGTACAGG	TGTCTCCGTCCTAGACTCATAGTC	95	SRC
GGTTATTCTTATTCTGTTACTTACGTGGACA	AGCATGTGTTACTCAGTGTCCC	86	ERBB4
CACCTGGGAGGATGGGTTTT	CCGCAGGTACTTGCCTGT	92	SRC
CCCTTTTATCTTCATCAGAGTATCCTGA	TGAGAGACTGAGATGGCACTGT	87	GNAQ
CCCGAATCGGAATCTGACCA	TCTCGGACTCGATTTCGGACT	88	GNAS
CAGCAGCCAATGTGCTTCG	GGCACAGGTCGTTGTAATTATGG	97	GNAS
CGTCTGCACGCTCTCAAGT	GTCCCTTGGATCTTTGTCCTCG	84	GNAS
CTCCACAGCTGAAAATGCAGAATAC	GCTTGGTCCTGGGTATCGAAAG	77	EGFR
CTACGGCAGAGAACCCAGAGTA	CTCTTGATGCCAGCAGAAGTCA	80	ERBB2
AAAATGAAAAGGTTGTGCAGCTGAA	CCGCTGTTGTTTTCTTCATTTCTGAT	84	PDGFRA
TTGTGACGGTCTTGGAAGTGAG	TGGCACATAGATGTAAATGTGCCT	78	PDGFRA
AGAGAGGTGGTGCTGAGTGT	GAGTGGTACCAAGAAGAGTGACTTC	80	FGFR1
TTGTTGTGTTGGAGGAAGACATCA	CCGGTCTCAGTCATCCCAG	96	CSF1R
TCTTTGCTCATCTTTTCTTTATGTTTTCGAATT	CTGTACACATGAAGCCATCGTATATATTCA	61	KRAS
ACAGTGAAAGATTCATCTAATGGTGCT	TCAAAACATACCTAACCACTGTTGCT	75	ATM
GTTTCTCCTTCAGGTACCCAAATACC	AGGTGCTAAATAAACATTTGTTGATTGAATGTT	80	ERBB4
GAACCTGGTGTGCAAAGTGG	CTCAGAGCGGGACGTGACCT	94	SRC
CAGTTCATACCTTGTTTGGGTTTGTC	CATGTCCAAGAGGACAGTAGCA	91	ERBB4
ACTTGCCTGAAGAAGTGTGGG	CCATGCCTGAGGCGATCTG	99	SRC
CATTACAGCAGGAGTCATCAAAAATCTC	AGATGGAGGTTTTGCTGCTGAA	74	ERBB4
CTCCAGAAGCTGCCCTCTATG	AGACAGGCCATGAGGACCTT	88	SRC
TGATGGGTGAATTTCCTGTAATGTATACAC	GCCCAAAGACTCACATTTAGGAAATACATA	79	ERBB4
TAGGAGGATGGTGGGCACCG	GATGTAGCCTGTCTGTCCTGTG	87	SRC
TCCGGTGTCTGTAAGGTGGA	CTGCAGGAGTACAGCACAAAATATTTTTAT	88	ERBB4
GGTGGCCATCAAAACCCTGAA	GCTCCTCTGAAACCACAGCATAC	80	SRC
GTCAGGGTTGTCAAACGCTTTC	CAAGGCCGAGGATGAGTATGTG	91	ERBB4
GCAAGGGCTGGGCGATATC	CACCCTCAGGACTATACCAATCTG	92	CSF1R
GTGATATTCGGGATTATCCAATGCTTG	TTTTCCAGAAACTAGAGGTTAGCTGATATTTTT	70	ERBB4
TGCGGACATATTTCTTCTCGAGG	GTACTGTTGCTATGGCGACCT	95	CSF1R
GAGTTTGCCATTGGCCTAGTCT	GCTGACAGTAGACCTAAATTTAAGGAACTG	79	ERBB4
CTCAGTGCAGCGATAGGTCC	CAATGGCAGCGTGGAATGG	87	CSF1R
TGTACAGATTGAGTAATCTCTGCTATTACT	AGAAAGGAGAACGTTTGCCTCA	87	ERBB4
CCCACACATCGCAAGGTCA	CATCCTAGACCTCACTTCTGTCTG	82	CSF1R
GCCATCTTCCATCTTCTCACACT	TTAAGTTGACGCTTGTTTGCTTACAC	76	ERBB4
GACGGAACAAGGTAGCCCTG	CTGGGCCAGCACGAGAACATC	90	CSF1R
ACTACCATTTGTTGACACAAGAGTCAA	TCCTAAATGGTGGAGTCTATGTAGACC	70	ERBB4
CCTGATGCTTGCTGAAGCATAC	CTACCTGGGACCCTTTTCTGAC	95	CSF1R
CCTGAATCAAATAGGGAAGGAAAGGA	TACGGACCTTACGTCAGTGACT	91	ERBB4
GGTAGGTCCAGTTAAAACCTTGCA	TCTGCTTTCCAGAGAGTGCCTA	91	CSF1R
CGCAGCCTTGAGTCTGTGTATT	AAGCTGCACTTTAGGATAACAAAGTCATA	81	ATM
GTTGACAACATTGGTGTGTAACAAAATC	AAAATACTTTACCTCTACAATGGTTAACAGA	70	ATM
GTGTCCCTTGCAAAAGGAAGAAAA	GACACTGAATGAGAAAATGGTAACACTTT	71	ATM
CTGTTAGGGATTTGGATCCTGCTC	GGAAAGAATTTCTAAAATGCTTTTTAACTTGG	68	ATM
AGTTTTAGTGGCTAGAATAATTCATGCTGT	AAAACAAAAGAAAAAGAGATTAGATTACCTCGC	75	ATM
TAACAGAAAATGACATGTTACCAAATATGAGGA	CTTGCCAAGTTGCTGTAGAAATTTCAA	64	JAK2
ATCAGAGTTGCGATGGAAGAACAA	AGCTGTAATTCATTTTATTCCTAATAGCTCTTC	67	APC
GTTAGCTGCTGGAGAAGGAGTT	AATTCAGGTATGGTTACAGATGAGGTTTTT	82	APC
CAGAGGAAGGTGATATTCTTGCAGAA	CTGATTTTTGTTGGGTGCAGAAGA	89	APC
AACCCATACTTCAGAAACAATCCACTT	ACTCAGAGAGGAATTATGAGAAAAGCAAAC	82	APC
GGGCTTACTAATGACCACTACAGTATTAC	CTCATACCTGAGCTATCTTAAGAAATACATGTT	72	APC
CAACCCTTTTTAAAAGTAATTGAACCAGTAGG	GAAATATTTTAGAAAGGGACAACAGTTAAGCTT	74	PIK3CA
CATCTGCCGTCACATTGTTCTG	AAGACAGGGTGAGAAATTGTCACTC	85	ERBB4
GCAGTAGTGCGTCCTGGT	ACCTATGTCCAGGTACTCCTTGG	98	CSF1R
AATTATTTCTTACCCTATTCGAGTCAATTCTT	CTTTCAGAATCTCTTGGATGAAGAGGAT	79	ERBB4
AAGAAAGAGGACATCCCACTGC	CGGCTGAAAGTGCAGAAAGG	95	CSF1R
GTTTTGTCCCACGAATAATGCGTAAA	TATAACACAGGCAACTGTTTGTGTCTT	72	ERBB4
GCCGGATGCTGATGGACATC	CTCATGCGCCACACCAACT	96	CSF1R
TGACAGGCACTTACCTTAGCTATCT	TCCAGCTGGTTACTCAACTTATGC	77	ERBB4
CTCCCAGTACCTACTTCCCTGT	GCTGGAGAGCTCTGACGTT	94	CSF1R
CGGACTAGGTGTGGATGATCCA	AGCACCATTAGTACAATCCAAGTAACTC	74	ERBB4
GGCCTGCATGATGCTGTATCT	TACTAAACTTACTTTGACTGGGTTTGGG	90	CSF1R
CAAGTCTGGCAATGATTTTCTGTGG	TAGTCAAGGAGTGAAAGATTATAACGTGC	71	ERBB4
TGAAATGTGTGTGATGCCTCTTGT	CAAGGAGGATGCTGTCCTGAA	93	CSF1R
AGCTTTTCTGTTGTCCCGGATT	AAATCAGCGCAGGAAACATCTATATTACT	73	ERBB4
CTCCAAAGGTGGAGCCAACCC	GGCCTTCATACCCATCTCTGC	97	CSF1R
GAGCCCTGCAGCTTTAAACATATC	TCTACTCTTCACTTGTAGGTTTCCTGA	88	ERBB4
CTCTAAGGTCTCAACAGTCAGCA	GCTTTTGCCAGGTGTGATGAG	81	CSF1R
GCGGAATGCATCCAGAGAGG	GCTTGTGCCGGAAGGCTT	88	HNF1A
CCTACTCACATTCTTGGAAGCGAG	CGCCTCTTCCCACCCTAGA	81	CSF1R
CCCACCAAGCAGGTAAGGTC	GCCTCAGTGTCTGAGGTGAAG	86	HNF1A
AGGTCTCCTTCCCTGACATCAG	CAAGCACTCCACCTCCATGTT	88	CSF1R
TAGGGCTGTCAGGCACGT	CGGTGATGAGCATAGTCTGCG	87	HNF1A
GGGTACCATCCAAATCTGGCT	CGCCTGCATGTCCATCATG	86	CSF1R
TTTGAAGTGCTGAGGGCTGT	CCGCTGCTTGAGGGTACTTC	96	HNF1A
GGTGAGTGGAGCCCACTTAC	CCCAGAGGTAAGCGTCATATGG	94	CSF1R
TCTTCCAGAGTAAATGTGTCAAATACTGG	AAAGTTTAAGTTCTCTTAGCGTATAGTCATGAG	63	PTPN11
CTGTTCAGGTGGAGGACCTTTT	GAGACCCACTCCCAGATTTTGG	84	MLH1
TCAAGCAAGAATGGGCTGGTAT	CATCTGACAAGGGAAATTATACCTGTGT	83	FGFR2
TCAGAAGTTAAGGCAGTGTTTTAGATGG	GTTCCATAGCCTGTTCAGGTTTGAT	86	PIK3CA
GCCATTTGTTTTGACACAGGATTTCT	TTGTTTCTAATAGAGCAGCCAGAACTC	86	PIK3CA
TGTGACTGCCATCATCTTCGTG	GTCACTCCACAAACCTGTTGTTC	88	GNAS
CTTCACTTGAATTGGTAGCATTTATAAATCCC	TTTCCTGTGTTAAACTGATGAATACAAGTTTAT	72	FLT3
GTGTTTTTAAATTTCTCTGCATCCACGA	GTGCTGCTGAAGGTCATGGAT	75	JAK3
GAGAAGGAGTCATTTGAAGAAGTGGA	CTGAGCAGTGCAGTGATGATGA	89	CSF1R
CCCAAGAAGACAGGACATCGTC	ACTCACCGAGAACCGCGTC	97	AKT1
CTCATGGATGATCTGACTTGGGTT	GGTACTTTACCGTCTGAGATACTGGA	85	ABL1
TTTTGAAAGTGCTTAATGTCTTGACATTTCA	TCTATTGTTAGTTTAACAACCTTGTAGCATTGT	74	NPM1
